Tanggal,Variant_Suspect,Day,ID_CUM_POSITIVE,ID_CUM_HOSPITALIZED,ID_CUM_CURED,ID_CUM_DEATH,JKT_CUM_POSITIVE,JKT_CUM_HOSPITALIZED,JKT_CUM_CURED,JKT_CUM_DEATH,JKT_CUM_SELFISOLATION,JKT_CUM_ACTIVEPOSITIVE,ID_DAILY_POSITIVE,ID_DAILY_HOSPITALIZED,ID_DAILY_CURED,ID_DAILY_DEATH,JKT_DAILY_DEATH,JKT_DAILY_CURED,JKT_DAILY_ISOLATION,JKT_DAILY_HOSPITALIZED,JKT_DAILY_POSITIVE,JKT_DAILY_ACTIVEPOSITIVE,JKT_DAILY_BURIAL,JKT_CUM_BURIAL,JKT_DAILY_TESTSPECIMENT,JKT_DAILY_POSTEST,PoF_Positive,JKT_DAILY_NEGTEST,JKT_DAILY_POSTRATE,PoF_PostRate,JKT_CONS_VALUE,CoF_HSE
01/03/2020,Alpha-Beta-Gamma,1,0,0,0,0,0,0,0,0,0,0,0,0,0,0,0,0,0,0,0,0,150,150,39,0,,39,0,1,0,1
02/03/2020,Alpha-Beta-Gamma,2,2,2,0,0,0,0,0,0,0,0,2,2,0,0,0,0,0,0,0,0,136,286,3,0,,3,0,1,0,1
03/03/2020,Alpha-Beta-Gamma,3,2,2,0,0,3,2,0,1,0,2,0,0,0,0,1,0,0,2,3,2,135,421,15,3,,12,0.2,2,10,1
04/03/2020,Alpha-Beta-Gamma,4,2,2,0,0,3,2,0,1,0,2,0,0,0,0,0,0,0,0,0,0,116,537,7,0,,7,0,1,0,1
05/03/2020,Alpha-Beta-Gamma,5,2,2,0,0,7,4,0,3,0,4,0,0,0,0,2,0,0,2,4,2,124,661,5,0,,5,0,1,14,1
06/03/2020,Alpha-Beta-Gamma,6,4,4,0,0,7,4,0,3,0,4,2,2,0,0,0,0,0,0,0,0,158,819,26,0,,26,0,1,0,1
07/03/2020,Alpha-Beta-Gamma,7,4,4,0,0,7,4,0,3,0,4,0,0,0,0,0,0,0,0,0,0,144,963,56,1,,55,0.017857143,1,0,1
08/03/2020,Alpha-Beta-Gamma,8,6,6,0,0,7,4,0,3,0,4,2,2,0,0,0,0,0,0,0,0,106,1069,73,27,,46,0.369863014,3,0,1
09/03/2020,Alpha-Beta-Gamma,9,19,19,0,0,34,31,0,3,0,31,13,13,0,0,0,0,0,27,27,27,145,1214,52,2,,50,0.038461538,1,81,1
10/03/2020,Alpha-Beta-Gamma,10,27,25,2,0,34,31,0,3,0,31,8,6,2,0,0,0,0,0,0,0,146,1360,48,26,,22,0.541666667,3,0,1
11/03/2020,Alpha-Beta-Gamma,11,34,31,2,1,36,33,0,3,0,33,7,6,0,1,0,0,0,2,2,2,148,1508,56,10,,46,0.178571429,2,6,1
12/03/2020,Alpha-Beta-Gamma,12,34,31,2,1,62,57,0,5,0,57,0,0,0,0,2,0,0,24,26,24,154,1662,30,7,,23,0.233333333,2,80,1
13/03/2020,Alpha-Beta-Gamma,13,69,63,2,4,72,65,0,7,0,65,35,32,0,3,2,0,0,8,10,8,124,1786,44,16,,28,0.363636364,3,32,1
14/03/2020,Alpha-Beta-Gamma,14,96,83,8,5,79,70,0,9,0,70,27,20,6,1,2,0,0,5,7,5,162,1948,41,2,,39,0.048780488,1,23,1
15/03/2020,Alpha-Beta-Gamma,15,117,104,8,5,95,84,0,11,0,84,21,21,0,0,2,0,0,14,16,14,119,2067,47,25,,22,0.531914894,3,50,1
16/03/2020,Alpha-Beta-Gamma,16,134,121,8,5,97,78,0,12,7,85,17,17,0,0,1,0,7,-6,2,1,128,2195,104,38,,66,0.365384615,3,-7,1
17/03/2020,Alpha-Beta-Gamma,17,172,158,9,5,122,83,0,12,27,110,38,37,1,0,0,0,20,5,25,25,135,2330,132,51,,81,0.386363636,3,35,1
18/03/2020,Alpha-Beta-Gamma,18,227,197,11,19,160,91,12,15,42,133,55,39,2,14,3,12,15,8,38,23,122,2452,154,13,,141,0.084415584,1,63,1
19/03/2020,Alpha-Beta-Gamma,19,309,269,15,25,210,121,13,19,57,178,82,72,4,6,4,1,15,30,50,45,108,2560,118,44,,74,0.372881356,3,122,1
20/03/2020,Alpha-Beta-Gamma,20,369,320,17,32,224,125,13,20,66,191,60,51,2,7,1,0,9,4,14,13,138,2698,501,39,,462,0.077844311,1,25,1
21/03/2020,Alpha-Beta-Gamma,21,450,392,20,38,268,157,17,23,71,228,81,72,3,6,3,4,5,32,44,37,118,2816,1097,49,,1048,0.044667274,1,117,1
22/03/2020,Alpha-Beta-Gamma,22,514,437,29,48,304,177,21,29,77,254,64,45,9,10,6,4,6,20,36,26,150,2966,378,71,,307,0.187830688,2,94,1
23/03/2020,Alpha-Beta-Gamma,23,579,500,30,49,355,225,22,29,79,304,65,63,1,1,0,1,2,48,51,50,151,3117,347,45,,302,0.129682997,2,147,2
24/03/2020,Alpha-Beta-Gamma,24,686,601,30,55,426,260,23,34,109,369,107,101,0,6,5,1,30,35,71,65,119,3236,196,43,,153,0.219387755,2,156,2
25/03/2020,Alpha-Beta-Gamma,25,790,701,31,58,472,290,27,43,112,402,104,100,1,3,9,4,3,30,46,33,160,3396,248,51,,197,0.205645161,2,133,2
26/03/2020,Alpha-Beta-Gamma,26,893,780,35,78,515,324,29,49,113,437,103,79,4,20,6,2,1,34,43,35,117,3513,199,37,,162,0.185929648,2,129,1
27/03/2020,Alpha-Beta-Gamma,27,1046,913,46,87,566,346,31,57,132,478,153,133,11,9,8,2,19,22,51,41,150,3663,359,98,,261,0.272980501,3,119,1
28/03/2020,Alpha-Beta-Gamma,28,1155,994,59,102,603,364,43,62,134,498,109,81,13,15,5,12,2,18,37,20,141,3804,127,26,,101,0.204724409,2,88,1
29/03/2020,Alpha-Beta-Gamma,29,1285,1107,64,114,701,435,48,67,151,586,130,113,5,12,5,5,17,71,98,88,153,3957,217,14,,203,0.064516129,1,255,2
30/03/2020,Alpha-Beta-Gamma,30,1414,1217,75,122,727,449,49,78,151,600,129,110,11,8,11,1,0,14,26,14,140,4097,300,75,,225,0.25,3,87,1
31/03/2020,Alpha-Beta-Gamma,31,1528,1311,81,136,741,451,49,84,157,608,114,94,6,14,6,0,6,2,14,8,148,4245,164,93,,71,0.567073171,3,36,1
01/04/2020,Alpha-Beta-Gamma,32,1677,1417,103,157,816,499,51,90,176,675,149,106,22,21,6,2,19,48,75,67,171,4416,455,81,,374,0.178021978,2,189,2
02/04/2020,Alpha-Beta-Gamma,33,1790,1508,112,170,909,565,54,95,195,760,113,91,9,13,5,3,19,66,93,85,178,4594,908,81,,827,0.089207048,1,240,2
03/04/2020,Alpha-Beta-Gamma,34,1986,1671,134,181,990,627,56,98,209,836,196,163,22,11,3,2,14,62,81,76,143,4737,1470,80,,1390,0.054421769,1,214,2
04/04/2020,Alpha-Beta-Gamma,35,2092,1751,150,191,1071,691,58,99,223,914,106,80,16,10,1,2,14,64,81,78,151,4888,1218,148,,1070,0.121510673,2,212,2
05/04/2020,Alpha-Beta-Gamma,36,2273,1911,164,198,1151,685,64,123,279,964,181,160,14,7,24,6,56,-6,80,50,160,5048,812,144,,668,0.177339901,2,140,2
06/04/2020,Alpha-Beta-Gamma,37,2491,2090,192,209,1299,783,68,131,317,1100,218,179,28,11,8,4,38,98,148,136,179,5227,877,109,,768,0.124287343,2,368,2
07/04/2020,Alpha-Beta-Gamma,38,2738,2313,204,221,1443,895,69,141,338,1233,247,223,12,12,10,1,21,112,144,133,159,5386,988,167,,821,0.16902834,2,398,2
08/04/2020,Alpha-Beta-Gamma,39,2956,2494,222,240,1552,976,75,144,357,1333,218,181,18,19,3,6,19,81,109,100,157,5543,1003,91,,912,0.090727817,2,280,2
09/04/2020,Alpha-Beta-Gamma,40,3293,2761,252,280,1719,1077,82,155,405,1482,337,267,30,40,11,7,48,101,167,149,134,5677,1304,93,,1211,0.071319018,1,402,2
10/04/2020,Alpha-Beta-Gamma,41,3512,2924,282,306,1810,1139,82,156,433,1572,219,163,30,26,1,0,28,62,91,90,152,5829,916,179,,737,0.195414847,2,218,2
11/04/2020,Alpha-Beta-Gamma,42,3842,3229,286,327,1903,1152,142,168,441,1593,330,305,4,21,12,60,8,13,93,21,148,5977,844,160,,684,0.18957346,2,155,2
12/04/2020,Alpha-Beta-Gamma,43,4241,3509,359,373,2082,1277,142,195,468,1745,399,280,73,46,27,0,27,125,179,152,147,6124,840,107,,733,0.127380952,2,510,2
13/04/2020,Alpha-Beta-Gamma,44,4557,3778,380,399,2242,1370,142,209,521,1891,316,269,21,26,14,0,53,93,160,146,173,6297,1114,98,,1016,0.087971275,1,388,2
14/04/2020,Alpha-Beta-Gamma,45,4839,3954,426,459,2349,1385,163,243,558,1943,282,176,46,60,34,21,37,15,107,52,167,6464,981,223,,758,0.227319062,2,239,2
15/04/2020,Alpha-Beta-Gamma,46,5136,4221,446,469,2447,1424,164,246,613,2037,297,267,20,10,3,1,55,39,98,94,143,6607,888,153,,735,0.172297297,2,185,2
16/04/2020,Alpha-Beta-Gamma,47,5516,4472,548,496,2670,1601,202,248,619,2220,380,251,102,27,2,38,6,177,223,183,172,6779,1214,79,,1135,0.065074135,1,583,2
17/04/2020,Alpha-Beta-Gamma,48,5923,4796,607,520,2823,1727,203,250,643,2370,407,324,59,24,2,1,24,126,153,150,145,6924,1123,131,,992,0.116651825,2,411,2
18/04/2020,Alpha-Beta-Gamma,49,6248,5082,631,535,2902,1769,206,257,670,2439,325,286,24,15,7,3,27,42,79,69,144,7068,1248,79,,1169,0.063301282,1,184,2
19/04/2020,Alpha-Beta-Gamma,50,6575,5307,686,582,3033,1839,207,292,695,2534,327,225,55,47,35,1,25,70,131,95,136,7204,1606,167,,1439,0.103985056,2,376,2
20/04/2020,Alpha-Beta-Gamma,51,6760,5423,747,590,3112,1826,237,297,752,2578,185,116,61,8,5,30,57,-13,79,44,163,7367,1599,120,,1479,0.075046904,1,68,1
21/04/2020,Alpha-Beta-Gamma,52,7135,5677,842,616,3279,1935,286,305,753,2688,375,254,95,26,8,49,1,109,167,110,153,7520,1552,107,,1445,0.068943299,1,409,2
22/04/2020,Alpha-Beta-Gamma,53,7418,5870,913,635,3399,1985,291,308,815,2800,283,193,71,19,3,5,62,50,120,112,179,7699,1714,99,,1615,0.057759627,1,229,2
23/04/2020,Alpha-Beta-Gamma,54,7775,6168,960,647,3506,2010,292,316,888,2898,357,298,47,12,8,1,73,25,107,98,169,7868,1599,76,,1523,0.047529706,1,181,2
24/04/2020,Alpha-Beta-Gamma,55,8211,6520,1002,689,3605,1988,327,331,959,2947,436,352,42,42,15,35,71,-22,99,49,149,8017,1278,65,,1213,0.05086072,1,100,1
25/04/2020,Alpha-Beta-Gamma,56,8607,6845,1042,720,3681,1947,334,350,1050,2997,396,325,40,31,19,7,91,-41,76,50,186,8203,803,86,,717,0.107098381,2,51,1
26/04/2020,Alpha-Beta-Gamma,57,8882,7032,1107,743,3746,1952,338,357,1099,3051,275,187,65,23,7,4,49,5,65,54,155,8358,1434,118,,1316,0.082287308,1,96,1
27/04/2020,Alpha-Beta-Gamma,58,9096,7180,1151,765,3832,1950,338,375,1169,3119,214,148,44,22,18,0,70,-2,86,68,140,8498,1904,83,,1821,0.043592437,1,136,2
28/04/2020,Alpha-Beta-Gamma,59,9511,7484,1254,773,3950,2024,341,379,1206,3230,415,304,103,8,4,3,37,74,118,111,124,8622,2276,105,,2171,0.046133568,1,278,2
29/04/2020,Alpha-Beta-Gamma,60,9771,7596,1391,784,4033,2002,412,381,1238,3240,260,112,137,11,2,71,32,-22,83,10,110,8732,2339,145,,2194,0.061992304,1,45,1
30/04/2020,Alpha-Beta-Gamma,61,10118,7804,1522,792,4138,2073,412,381,1272,3345,347,208,131,8,0,0,34,71,105,105,125,8857,2496,72,,2424,0.028846154,1,247,2
01/05/2020,Alpha-Beta-Gamma,62,10551,8160,1591,800,4283,2151,427,393,1312,3463,433,356,69,8,12,15,40,78,145,118,125,8982,2211,62,,2149,0.02804161,1,337,2
02/05/2020,Alpha-Beta-Gamma,63,10843,8347,1665,831,4355,2089,562,400,1304,3393,292,187,74,31,7,135,-8,-62,72,-70,149,9131,1127,55,,1072,0.04880213,1,-31,1
03/05/2020,Alpha-Beta-Gamma,64,11192,8471,1876,845,4417,2062,622,410,1323,3385,349,124,211,14,10,60,19,-27,62,-8,129,9260,2594,169,,2425,0.065150347,1,38,1
04/05/2020,Alpha-Beta-Gamma,65,11587,8769,1954,864,4472,2080,650,412,1330,3410,395,298,78,19,2,28,7,18,55,25,162,9422,2520,68,,2452,0.026984127,1,97,1
05/05/2020,Alpha-Beta-Gamma,66,12071,9002,2197,872,4641,2146,711,414,1370,3516,484,233,243,8,2,61,40,66,169,106,145,9567,2985,66,,2919,0.022110553,1,307,2
06/05/2020,Alpha-Beta-Gamma,67,12438,9226,2317,895,4709,2195,713,420,1381,3576,367,224,120,23,6,2,11,49,68,60,132,9699,1733,126,,1607,0.07270629,1,184,2
07/05/2020,Alpha-Beta-Gamma,68,12776,9465,2381,930,4775,2196,718,430,1431,3627,338,239,64,35,10,5,50,1,66,51,139,9838,2500,57,,2443,0.0228,1,98,1
08/05/2020,Alpha-Beta-Gamma,69,13112,9675,2494,943,4901,2281,763,431,1426,3707,336,210,113,13,1,45,-5,85,126,80,160,9998,2629,182,,2447,0.069227843,1,299,2
09/05/2020,Alpha-Beta-Gamma,70,13645,10079,2607,959,4958,2312,767,437,1442,3754,533,404,113,16,6,4,16,31,57,47,139,10137,1490,55,,1435,0.036912752,1,137,2
10/05/2020,Alpha-Beta-Gamma,71,14032,10361,2698,973,5140,2360,803,444,1533,3893,387,282,91,14,7,36,91,48,182,139,152,10289,2575,108,,2467,0.041941748,1,299,2
11/05/2020,Alpha-Beta-Gamma,72,14265,10393,2881,991,5195,2258,836,453,1648,3906,233,32,183,18,9,33,115,-102,55,13,112,10401,3119,134,,2985,0.042962488,1,-122,1
12/05/2020,Alpha-Beta-Gamma,73,14749,10679,3063,1007,5303,1843,1262,457,1741,3584,484,286,182,16,4,426,93,-415,108,-322,139,10540,2601,180,,2421,0.069204152,1,-710,1
13/05/2020,Alpha-Beta-Gamma,74,15438,11123,3287,1028,5437,1833,1277,461,1866,3699,689,444,224,21,4,15,125,-10,134,115,165,10705,2500,62,,2438,0.0248,1,126,1
14/05/2020,Alpha-Beta-Gamma,75,16006,11445,3518,1043,5617,1877,1279,466,1995,3872,568,322,231,15,5,2,129,44,180,173,147,10852,2433,116,,2317,0.047677764,1,283,2
15/05/2020,Alpha-Beta-Gamma,76,16496,11617,3803,1076,5679,1900,1286,474,2019,3919,490,172,285,33,8,7,24,23,62,47,154,11006,2006,127,,1879,0.06331007,1,132,2
16/05/2020,Alpha-Beta-Gamma,77,17025,12025,3911,1089,5795,1908,1292,475,2120,4028,529,408,108,13,1,6,101,8,116,109,164,11170,1673,88,,1585,0.05260012,1,135,2
17/05/2020,Alpha-Beta-Gamma,78,17514,12237,4129,1148,5922,1932,1295,478,2217,4149,489,212,218,59,3,3,97,24,127,121,171,11341,2194,43,,2151,0.019598906,1,184,2
18/05/2020,Alpha-Beta-Gamma,79,18010,12495,4324,1191,5996,1946,1301,483,2266,4212,496,258,195,43,5,6,49,14,74,63,128,11469,2530,97,,2433,0.038339921,1,117,1
19/05/2020,Alpha-Beta-Gamma,80,18496,12808,4467,1221,6053,1936,1417,487,2213,4149,486,313,143,30,4,116,-53,-10,57,-63,144,11613,2457,72,,2385,0.029304029,1,49,1
20/05/2020,Alpha-Beta-Gamma,81,19189,13372,4575,1242,6150,1969,1425,493,2263,4232,693,564,108,21,6,8,50,33,97,83,138,11751,1907,97,,1810,0.050865233,1,181,2
21/05/2020,Alpha-Beta-Gamma,82,20162,14046,4838,1278,6220,1955,1536,498,2231,4186,973,674,263,36,5,111,-32,-14,70,-46,139,11890,3214,127,,3087,0.039514624,1,57,1
22/05/2020,Alpha-Beta-Gamma,83,20796,14413,5057,1326,6316,1975,1558,501,2282,4257,634,367,219,48,3,22,51,20,96,71,119,12009,1764,118,,1646,0.066893424,1,145,2
23/05/2020,Alpha-Beta-Gamma,84,21745,15145,5249,1351,6443,2006,1587,504,2346,4352,949,732,192,25,3,29,64,31,127,95,132,12141,871,67,,804,0.076923077,1,198,2
24/05/2020,Alpha-Beta-Gamma,85,22271,15497,5402,1372,6561,2031,1594,505,2431,4462,526,352,153,21,1,7,85,25,118,110,126,12267,1321,93,,1228,0.070401211,1,171,2
25/05/2020,Alpha-Beta-Gamma,86,22750,15717,5642,1391,6628,2044,1648,506,2430,4474,479,220,240,19,1,54,-1,13,67,12,165,12432,1972,105,,1867,0.053245436,1,96,1
26/05/2020,Alpha-Beta-Gamma,87,23165,15870,5877,1418,6689,2044,1678,508,2459,4503,415,153,235,27,2,30,29,0,61,29,166,12598,2271,103,,2168,0.045354469,1,67,1
27/05/2020,Alpha-Beta-Gamma,88,23851,16321,6057,1473,6826,2034,1698,510,2584,4618,686,451,180,55,2,20,125,-10,137,115,154,12752,2768,124,,2644,0.044797688,1,123,1
28/05/2020,Alpha-Beta-Gamma,89,24538,16802,6240,1496,6929,2055,1719,514,2641,4696,687,481,183,23,4,21,57,21,103,78,147,12899,2392,100,,2292,0.04180602,1,157,2
29/05/2020,Alpha-Beta-Gamma,90,25216,17204,6492,1520,7053,2007,1807,517,2722,4729,678,402,252,24,3,88,81,-48,124,33,155,13054,2808,119,,2689,0.042378917,1,37,1
30/05/2020,Alpha-Beta-Gamma,91,25773,17185,7015,1573,7151,1848,2003,519,2781,4629,557,-19,523,53,2,196,59,-159,98,-100,132,13186,1858,111,,1747,0.059741658,1,-214,1
31/05/2020,Alpha-Beta-Gamma,92,26473,17552,7308,1613,7272,1823,2102,520,2827,4650,700,367,293,40,1,99,46,-25,121,21,126,13312,1789,73,,1716,0.040804919,1,74,1
01/06/2020,Alpha-Beta-Gamma,93,26940,17662,7637,1641,7383,1794,2246,521,2822,4616,467,110,329,28,1,144,-5,-29,111,-34,126,13438,2371,101,,2270,0.04259806,1,56,1
02/06/2020,Alpha-Beta-Gamma,94,27549,17951,7935,1663,7459,1743,2405,525,2786,4529,609,289,298,22,4,159,-36,-51,76,-87,138,13576,3422,62,,3360,0.01811806,1,-14,1
03/06/2020,Alpha-Beta-Gamma,95,28233,18129,8406,1698,7539,1699,2534,529,2777,4476,684,178,471,35,4,129,-9,-44,80,-53,145,13721,2738,83,,2655,0.030314098,1,4,1
04/06/2020,Alpha-Beta-Gamma,96,28818,18205,8892,1721,7600,1670,2607,530,2793,4463,585,76,486,23,1,73,16,-29,61,-13,138,13859,2864,102,,2762,0.035614525,1,6,1
05/06/2020,Alpha-Beta-Gamma,97,29521,18308,9443,1770,7684,1633,2751,532,2768,4401,703,103,551,49,2,144,-25,-37,84,-62,125,13984,3334,160,,3174,0.047990402,1,16,1
06/06/2020,Alpha-Beta-Gamma,98,30514,18806,9907,1801,7786,1635,2840,535,2776,4411,993,498,464,31,3,89,8,2,102,10,149,14133,1808,96,,1712,0.053097345,1,115,1
07/06/2020,Alpha-Beta-Gamma,99,31186,18837,10498,1851,7946,1445,3170,537,2794,4239,672,31,591,50,2,330,18,-190,160,-172,127,14260,2798,194,,2604,0.069335239,1,-214,1
08/06/2020,Alpha-Beta-Gamma,100,32033,19246,10904,1883,8037,1448,3205,538,2846,4294,847,409,406,32,1,35,52,3,91,55,131,14391,3590,187,,3403,0.052089136,1,100,1
09/06/2020,Alpha-Beta-Gamma,101,33076,19739,11414,1923,8276,1442,3369,547,2918,4360,1043,493,510,40,9,164,72,-6,239,66,127,14518,4064,129,,3935,0.031742126,1,254,2
10/06/2020,Alpha-Beta-Gamma,102,34316,20228,12129,1959,8423,1427,3517,551,2928,4355,1240,489,715,36,4,148,10,-15,147,-5,132,14650,2827,76,,2751,0.026883622,1,129,1
11/06/2020,Alpha-Beta-Gamma,103,35295,20659,12636,2000,8552,1446,3664,555,2887,4333,979,431,507,41,4,147,-41,19,129,-22,116,14766,3411,120,,3291,0.035180299,1,179,2
12/06/2020,Alpha-Beta-Gamma,104,36406,21145,13213,2048,8628,1424,3780,561,2863,4287,1111,486,577,48,6,116,-24,-22,76,-46,133,14899,4955,115,,4840,0.02320888,1,50,1
13/06/2020,Alpha-Beta-Gamma,105,37420,21553,13776,2091,8748,1419,3840,564,2925,4344,1014,408,563,43,3,60,62,-5,120,57,126,15025,1851,105,,1746,0.056726094,1,119,1
14/06/2020,Alpha-Beta-Gamma,106,38277,21612,14531,2134,8863,1368,4091,571,2833,4201,857,59,755,43,7,251,-92,-51,115,-143,129,15154,4605,94,,4511,0.020412595,1,34,1
15/06/2020,Alpha-Beta-Gamma,107,39294,21973,15123,2198,8968,1390,4198,580,2800,4190,1017,361,592,64,9,107,-33,22,105,-11,145,15299,4702,147,,4555,0.031263292,1,176,2
16/06/2020,Alpha-Beta-Gamma,108,40400,22466,15703,2231,9092,1416,4329,583,2764,4180,1106,493,580,33,3,131,-36,26,124,-10,145,15444,4740,176,,4564,0.037130802,1,185,2
17/06/2020,Alpha-Beta-Gamma,109,41431,22912,16243,2276,9209,1402,4444,588,2775,4177,1031,446,540,45,5,115,11,-14,117,-3,150,15594,4260,140,,4120,0.03286385,1,104,1
18/06/2020,Alpha-Beta-Gamma,110,42762,23625,16798,2339,9385,1377,4592,594,2822,4199,1331,713,555,63,6,148,47,-25,176,22,135,15729,4794,178,,4616,0.037129746,1,144,2
19/06/2020,Alpha-Beta-Gamma,111,43803,24081,17349,2373,9525,1382,4682,599,2862,4244,1041,456,551,34,5,90,40,5,140,45,119,15848,3258,132,,3126,0.040515654,1,165,2
20/06/2020,Alpha-Beta-Gamma,112,45029,24717,17883,2429,9703,1340,4821,603,2939,4279,1226,636,534,56,4,139,77,-42,178,35,125,15973,2806,132,,2674,0.047042053,1,106,1
21/06/2020,Alpha-Beta-Gamma,113,45891,25022,18404,2465,9830,1287,5054,615,2874,4161,862,305,521,36,12,233,-65,-53,127,-118,120,16093,3627,171,,3456,0.047146402,1,57,1
22/06/2020,Alpha-Beta-Gamma,114,46845,25610,18735,2500,9957,1310,5128,618,2901,4211,954,588,331,35,3,74,27,23,127,50,124,16217,5986,159,,5827,0.026561978,1,182,2
23/06/2020,Alpha-Beta-Gamma,115,47896,26120,19241,2535,10123,1319,5228,619,2957,4276,1051,510,506,35,1,100,56,9,166,65,123,16340,5142,195,,4947,0.037922987,1,187,2
24/06/2020,Alpha-Beta-Gamma,116,49009,26778,19658,2573,10277,1349,5322,628,2978,4327,1113,658,417,38,9,94,21,30,154,51,129,16469,5444,168,,5276,0.030859662,1,241,2
25/06/2020,Alpha-Beta-Gamma,117,50187,27118,20449,2620,10472,1338,5435,631,3068,4406,1178,340,791,47,3,113,90,-11,195,79,125,16594,5295,213,,5082,0.040226629,1,182,2
26/06/2020,Alpha-Beta-Gamma,118,51427,27411,21333,2683,10640,1330,5542,632,3136,4466,1240,293,884,63,1,107,68,-8,168,60,148,16742,4440,148,,4292,0.033333333,1,155,2
27/06/2020,Alpha-Beta-Gamma,119,52812,28183,21909,2720,10853,1355,5610,632,3256,4611,1385,772,576,37,0,68,120,25,213,145,144,16886,2434,95,,2339,0.039030403,1,263,2
28/06/2020,Alpha-Beta-Gamma,120,54010,28320,22936,2754,10985,1322,5865,635,3163,4485,1198,137,1027,34,3,255,-93,-33,132,-126,128,17014,4598,198,,4400,0.043062201,1,75,1
29/06/2020,Alpha-Beta-Gamma,121,55092,28487,23800,2805,11080,1027,6118,636,3299,4326,1082,167,864,51,1,253,136,-295,95,-159,126,17140,4618,204,,4414,0.044174968,1,-492,1
30/06/2020,Alpha-Beta-Gamma,122,56385,28703,24806,2876,11276,951,6512,641,3172,4123,1293,216,1006,71,5,394,-127,-76,196,-203,147,17287,4257,198,,4059,0.046511628,1,59,1
01/07/2020,Alpha-Beta-Gamma,123,57770,29241,25595,2934,11482,889,6680,644,3269,4158,1385,538,789,58,3,168,97,-62,206,35,139,17426,4255,144,,4111,0.033842538,1,91,1
02/07/2020,Alpha-Beta-Gamma,124,59394,29740,26667,2987,11677,804,6871,646,3356,4160,1624,499,1072,53,2,191,87,-85,195,2,122,17548,5955,215,,5740,0.036104114,1,31,1
03/07/2020,Alpha-Beta-Gamma,125,60695,30091,27568,3036,11824,736,7109,648,3331,4067,1301,351,901,49,2,238,-25,-68,147,-93,117,17665,4305,256,,4049,0.059465738,1,17,1
04/07/2020,Alpha-Beta-Gamma,126,62142,30834,28219,3089,12039,646,7377,650,3366,4012,1447,743,651,53,2,268,35,-90,215,-55,142,17807,3092,231,,2861,0.074708926,1,41,1
05/07/2020,Alpha-Beta-Gamma,127,63749,31473,29105,3171,12295,584,7663,658,3390,3974,1607,639,886,82,8,286,24,-62,256,-38,116,17923,4441,199,,4242,0.044809728,1,156,2
06/07/2020,Alpha-Beta-Gamma,128,64958,31798,29919,3241,12526,495,8033,658,3340,3835,1209,325,814,70,0,370,-50,-89,231,-139,127,18050,5473,308,,5165,0.056276265,1,53,1
07/07/2020,Alpha-Beta-Gamma,129,66226,32132,30785,3309,12725,405,8277,664,3379,3784,1268,334,866,68,6,244,39,-90,199,-51,112,18162,6486,293,,6193,0.045174221,1,37,1
08/07/2020,Alpha-Beta-Gamma,130,68079,33135,31585,3359,13069,417,8429,667,3556,3973,1853,1003,800,50,3,152,177,12,344,189,145,18307,6423,236,,6187,0.036742955,1,377,2
09/07/2020,Alpha-Beta-Gamma,131,70736,34668,32651,3417,13359,451,8647,677,3584,4035,2657,1533,1066,58,10,218,28,34,290,62,126,18433,6584,359,,6225,0.054526124,1,388,2
10/07/2020,Alpha-Beta-Gamma,132,72347,35349,33529,3469,13598,476,8825,684,3613,4089,1611,681,878,52,7,178,29,25,239,54,118,18551,5690,404,,5286,0.071001757,1,310,2
11/07/2020,Alpha-Beta-Gamma,133,74018,35764,34719,3535,13957,495,9040,690,3732,4227,1671,415,1190,66,6,215,119,19,359,138,146,18697,4102,279,,3823,0.068015602,1,415,2
12/07/2020,Alpha-Beta-Gamma,134,75699,36455,35638,3606,14361,554,9200,702,3905,4459,1681,691,919,71,12,160,173,59,404,232,139,18836,5998,275,,5723,0.045848616,1,558,2
13/07/2020,Alpha-Beta-Gamma,135,76981,36636,36689,3656,14639,597,9408,710,3924,4521,1282,181,1051,50,8,208,19,43,278,62,132,18968,5414,258,,5156,0.04765423,1,388,2
14/07/2020,Alpha-Beta-Gamma,136,78572,37226,37636,3710,14914,619,9528,714,4053,4672,1591,590,947,54,4,120,129,22,275,151,146,19114,6405,304,,6101,0.04746292,1,331,2
15/07/2020,Alpha-Beta-Gamma,137,80094,37247,39050,3797,15173,691,9721,720,4041,4732,1522,21,1414,87,6,193,-12,72,259,60,137,19251,6448,231,,6217,0.035825062,1,421,2
16/07/2020,Alpha-Beta-Gamma,138,81668,37450,40345,3873,15466,777,9857,722,4110,4887,1574,203,1295,76,2,136,69,86,293,155,111,19362,9056,331,,8725,0.036550353,1,471,2
17/07/2020,Alpha-Beta-Gamma,139,83130,37339,41834,3957,15707,826,9994,731,4156,4982,1462,-111,1489,84,9,137,46,49,241,95,131,19493,6781,312,,6469,0.046010913,1,366,2
18/07/2020,Alpha-Beta-Gamma,140,84882,37598,43268,4016,16038,892,10117,740,4289,5181,1752,259,1434,59,9,123,133,66,331,199,150,19643,3655,361,,3294,0.09876881,2,490,2
19/07/2020,Alpha-Beta-Gamma,141,86521,36977,45401,4143,16351,923,10444,748,4236,5159,1639,-621,2133,127,8,327,-53,31,313,-22,123,19766,6088,441,,5647,0.072437582,1,399,2
20/07/2020,Alpha-Beta-Gamma,142,88214,36998,46977,4239,16712,1026,10602,749,4335,5361,1693,21,1576,96,1,158,99,103,361,202,151,19917,8081,382,,7699,0.047271377,1,570,2
21/07/2020,Alpha-Beta-Gamma,143,89869,37083,48466,4320,17153,1073,10864,758,4458,5531,1655,85,1489,81,9,262,123,47,441,170,152,20069,10061,416,,9645,0.041347779,1,562,2
22/07/2020,Alpha-Beta-Gamma,144,91751,37037,50255,4459,17529,1193,11187,766,4383,5576,1882,-46,1789,139,8,323,-75,120,376,45,132,20201,8773,279,,8494,0.03180212,1,640,2
23/07/2020,Alpha-Beta-Gamma,145,93657,36917,52164,4576,17945,1201,11302,767,4675,5876,1906,-120,1909,117,1,115,292,8,416,300,168,20369,9100,393,,8707,0.043186813,1,435,2
24/07/2020,Alpha-Beta-Gamma,146,95418,36808,53945,4665,18230,1300,11585,768,4577,5877,1761,-109,1781,89,1,283,-98,99,285,1,155,20524,6887,611,,6276,0.088717874,1,486,2
25/07/2020,Alpha-Beta-Gamma,147,97286,37218,55354,4714,18623,1410,11715,769,4729,6139,1868,410,1409,49,1,130,152,110,393,262,140,20664,3148,270,,2878,0.085768742,1,616,2
26/07/2020,Alpha-Beta-Gamma,148,98778,37342,56655,4781,19001,1491,11889,779,4842,6333,1492,124,1301,67,10,174,113,81,378,194,117,20781,8184,436,,7748,0.053274682,1,570,2
27/07/2020,Alpha-Beta-Gamma,149,100303,37292,58173,4838,19473,1702,11996,782,4993,6695,1525,-50,1518,57,3,107,151,211,472,362,143,20924,8824,542,,8282,0.061423391,1,903,2
28/07/2020,Alpha-Beta-Gamma,150,102051,36611,60539,4901,19885,1848,12373,795,4869,6717,1748,-681,2366,63,13,377,-124,146,412,22,144,21068,9120,340,,8780,0.037280702,1,743,2
29/07/2020,Alpha-Beta-Gamma,151,104432,37319,62138,4975,20470,1944,12613,820,5093,7037,2381,708,1599,74,25,240,224,96,585,320,147,21215,8520,585,,7935,0.068661972,1,852,2
30/07/2020,Alpha-Beta-Gamma,152,106336,36986,64292,5058,20769,2049,12801,821,5098,7147,1904,-333,2154,83,1,188,5,105,299,110,141,21356,4222,330,,3892,0.078162009,1,512,2
31/07/2020,Alpha-Beta-Gamma,153,108376,37338,65907,5131,21201,2183,13208,836,4974,7157,2040,352,1615,73,15,407,-124,134,432,10,152,21508,6366,329,,6037,0.051680804,1,745,2
01/08/2020,Alpha-Beta-Gamma,154,109936,36824,67919,5193,21575,2153,13887,852,4683,6836,1560,-514,2012,62,16,679,-291,-30,374,-321,151,21659,3675,439,,3236,0.119455782,2,362,2
02/08/2020,Alpha-Beta-Gamma,155,111455,37244,68975,5236,21954,2159,14027,852,4916,7075,1519,420,1056,43,0,140,233,6,379,239,141,21800,7811,386,,7425,0.049417488,1,391,2
03/08/2020,Alpha-Beta-Gamma,156,113134,37595,70237,5302,22443,2327,14165,867,5084,7411,1679,351,1262,66,15,138,168,168,489,336,129,21929,7071,468,,6603,0.066185829,1,870,2
04/08/2020,Alpha-Beta-Gamma,157,115056,37618,72050,5388,22909,2432,14381,880,5216,7648,1922,23,1813,86,13,216,132,105,466,237,152,22081,8124,584,,7540,0.071885771,1,715,2
05/08/2020,Alpha-Beta-Gamma,158,116871,37530,73889,5452,23266,2483,14760,895,5128,7611,1815,-88,1839,64,15,379,-88,51,357,-37,138,22219,8065,693,,7372,0.085926844,1,504,2
06/08/2020,Alpha-Beta-Gamma,159,118753,37587,75645,5521,23863,2552,15006,908,5397,7949,1882,57,1756,69,13,246,269,69,597,338,130,22349,8791,776,,8015,0.088272096,1,774,2
07/08/2020,Alpha-Beta-Gamma,160,121226,38076,77557,5593,24521,2595,15201,922,5803,8398,2473,489,1912,72,14,195,406,43,658,449,159,22508,6771,534,,6237,0.078865751,1,786,2
08/08/2020,Alpha-Beta-Gamma,161,123503,38539,79306,5658,25242,2488,15710,934,6110,8598,2277,463,1749,65,12,509,307,-107,721,200,162,22670,4433,319,,4114,0.071960298,1,543,2
09/08/2020,Alpha-Beta-Gamma,162,125396,38721,80952,5723,25714,2416,16268,939,6091,8507,1893,182,1646,65,5,558,-19,-72,472,-91,145,22815,6059,582,,5477,0.096055455,2,343,2
10/08/2020,Alpha-Beta-Gamma,163,127083,39082,82236,5765,26193,2555,16446,940,6252,8807,1687,361,1284,42,1,178,161,139,479,300,167,22982,5841,487,,5354,0.083376134,1,760,2
11/08/2020,Alpha-Beta-Gamma,164,128776,39242,83710,5824,26664,2548,16927,953,6236,8784,1693,160,1474,59,13,481,-16,-7,471,-23,136,23118,8015,591,,7424,0.073736744,1,496,2
12/08/2020,Alpha-Beta-Gamma,165,130718,39017,85798,5903,27242,2717,17349,968,6208,8925,1942,-225,2088,79,15,422,-28,169,578,141,150,23268,6881,495,,6386,0.071937218,1,961,2
13/08/2020,Alpha-Beta-Gamma,166,132816,39290,87558,5968,27863,2714,17838,981,6330,9044,2098,273,1760,65,13,489,122,-3,621,119,149,23417,8211,729,,7482,0.088783339,1,654,2
14/08/2020,Alpha-Beta-Gamma,167,135123,39484,89618,6021,28438,2594,18528,985,6331,8925,2307,194,2060,53,4,690,1,-120,575,-119,152,23569,9669,625,,9044,0.06463957,1,347,2
15/08/2020,Alpha-Beta-Gamma,168,137468,40076,91321,6071,29036,2614,18974,991,6457,9071,2345,592,1703,50,6,446,126,20,598,146,150,23719,5266,534,,4732,0.101405241,2,656,2
16/08/2020,Alpha-Beta-Gamma,169,139549,40296,93103,6150,29554,2567,19708,995,6284,8851,2081,220,1782,79,4,734,-173,-47,518,-220,143,23862,7215,555,,6660,0.076923077,1,436,2
17/08/2020,Alpha-Beta-Gamma,170,141370,40705,94458,6207,30092,2651,19916,1011,6514,9165,1821,409,1355,57,16,208,230,84,538,314,157,24019,7097,601,,6496,0.084683669,1,754,2
18/08/2020,Alpha-Beta-Gamma,171,143043,40460,96306,6277,30597,2462,20505,1028,6602,9064,1673,-245,1848,70,17,589,88,-189,505,-101,145,24164,10636,695,,9941,0.065344114,1,178,2
19/08/2020,Alpha-Beta-Gamma,172,144945,39942,98657,6346,31162,2559,21069,1046,6488,9047,1902,-518,2351,69,18,564,-114,97,565,-17,147,24311,5422,511,,4911,0.094245666,2,813,2
20/08/2020,Alpha-Beta-Gamma,173,147211,40119,100674,6418,31757,2544,21795,1061,6357,8901,2266,177,2017,72,15,726,-131,-15,595,-146,168,24479,7422,760,,6662,0.102398275,2,610,2
21/08/2020,Alpha-Beta-Gamma,174,149408,39917,102991,6500,32398,2576,22228,1076,6518,9094,2197,-202,2317,82,15,433,161,32,641,193,160,24639,6821,854,,5967,0.125201583,2,750,2
22/08/2020,Alpha-Beta-Gamma,175,151498,39706,105198,6594,32999,2762,22877,1091,6269,9031,2090,-211,2207,94,15,649,-249,186,601,-63,157,24796,3691,508,,3183,0.137632078,2,1018,2
23/08/2020,Alpha-Beta-Gamma,176,153535,39355,107500,6680,33636,2922,23567,1107,6040,8962,2037,-351,2302,86,16,690,-229,160,637,-69,139,24935,8941,704,,8237,0.078738396,1,1005,2
24/08/2020,Alpha-Beta-Gamma,177,155412,37593,111060,6759,34295,2630,25463,1112,5090,7720,1877,-1762,3560,79,5,1896,-950,-292,659,-1242,162,25097,8794,569,,8225,0.064703207,1,90,1
25/08/2020,Alpha-Beta-Gamma,178,157859,38134,112867,6858,34931,2686,25986,1129,5130,7816,2447,541,1807,99,17,523,40,56,636,96,161,25258,11436,907,,10529,0.079310948,1,799,2
26/08/2020,Alpha-Beta-Gamma,179,160165,37812,115409,6944,35642,2770,26750,1144,4978,7748,2306,-322,2542,86,15,764,-152,84,711,-68,167,25425,9360,879,,8481,0.093910256,2,924,2
27/08/2020,Alpha-Beta-Gamma,180,162884,37245,118575,7064,36462,2528,28288,1147,4499,7027,2719,-567,3166,120,3,1538,-479,-242,820,-721,165,25590,10266,882,,9384,0.08591467,1,345,2
28/08/2020,Alpha-Beta-Gamma,181,165887,37818,120900,7169,37278,2827,29169,1154,4128,6955,3003,573,2325,105,7,881,-371,299,816,-72,180,25770,9392,974,,8418,0.103705281,2,1435,2
29/08/2020,Alpha-Beta-Gamma,182,169195,39132,122802,7261,38166,2812,29768,1172,4414,7226,3308,1314,1902,92,18,599,286,-15,888,271,152,25922,4880,703,,4177,0.144057377,2,912,2
30/08/2020,Alpha-Beta-Gamma,183,172053,40525,124185,7343,39280,3015,30134,1186,4945,7960,2858,1393,1383,82,14,366,531,203,1114,734,227,26149,7514,1024,,6490,0.136278946,2,1562,3
31/08/2020,Alpha-Beta-Gamma,184,174796,41420,125959,7417,40309,3288,30538,1202,5281,8569,2743,895,1774,74,16,404,336,273,1029,609,166,26315,8222,1121,,7101,0.136341523,2,1623,3
01/09/2020,Alpha-Beta-Gamma,185,177571,42009,128057,7505,41250,3341,31267,1219,5423,8764,2775,589,2098,88,17,729,142,53,941,195,281,26596,9971,1135,,8836,0.113830107,2,1098,2
02/09/2020,Alpha-Beta-Gamma,186,180646,43059,129971,7616,42303,3568,31741,1237,5757,9325,3075,1050,1914,111,18,474,334,227,1053,561,181,26777,12131,1013,,11118,0.08350507,1,1561,2
03/09/2020,Alpha-Beta-Gamma,187,184268,44463,132055,7750,43709,3709,32424,1253,6323,10032,3622,1404,2084,134,16,683,566,141,1406,707,155,26932,10248,1242,,9006,0.121194379,2,1736,3
04/09/2020,Alpha-Beta-Gamma,188,187537,45524,134181,7832,44604,3827,33260,1260,6257,10084,3269,1061,2126,82,7,836,-66,118,895,52,176,27108,9866,1130,,8736,0.114534766,2,1152,2
05/09/2020,Alpha-Beta-Gamma,189,190665,46324,136401,7940,45446,3677,33991,1277,6501,10178,3128,800,2220,108,17,731,244,-150,842,94,216,27324,4979,703,,4276,0.141193011,2,593,2
06/09/2020,Alpha-Beta-Gamma,190,194109,47509,138575,8025,46691,4082,34738,1289,6582,10664,3444,1185,2174,85,12,747,81,405,1245,486,183,27507,12302,1289,,11013,0.104779711,2,2091,3
07/09/2020,Alpha-Beta-Gamma,191,196989,48207,140652,8130,47796,4341,35431,1318,6706,11047,2880,698,2077,105,29,693,124,259,1105,383,160,27667,12891,1326,,11565,0.102862462,2,1710,3
08/09/2020,Alpha-Beta-Gamma,192,200035,48847,142958,8230,48811,4432,36451,1330,6598,11030,3046,640,2306,100,12,1020,-108,91,1015,-17,189,27856,10005,1102,,8903,0.110144928,2,1233,2
09/09/2020,Alpha-Beta-Gamma,193,203342,49806,145200,8336,49837,4554,37245,1347,6691,11245,3307,959,2242,106,17,794,93,122,1026,215,205,28061,12103,1203,,10900,0.099396844,2,1321,2
10/09/2020,Alpha-Beta-Gamma,194,207203,51237,147510,8456,51287,4728,38226,1365,6968,11696,3861,1431,2310,120,18,981,277,174,1450,451,214,28275,10311,1435,,8876,0.139171758,2,1852,3
11/09/2020,Alpha-Beta-Gamma,195,210940,52179,150217,8544,52321,4681,39115,1382,7143,11824,3737,942,2707,88,17,889,175,-47,1034,128,186,28461,10567,1702,,8865,0.161067474,2,991,2
12/09/2020,Alpha-Beta-Gamma,196,214746,53638,152458,8650,53761,4684,40183,1404,7490,12174,3806,1459,2241,106,22,1068,347,3,1440,350,189,28650,5085,768,,4317,0.151032448,2,1512,2
13/09/2020,Alpha-Beta-Gamma,197,218382,54649,155010,8723,54864,4649,41014,1410,7791,12440,3636,1011,2552,73,6,831,301,-35,1103,266,158,28808,12510,1263,,11247,0.100959233,2,1051,2
14/09/2020,Alpha-Beta-Gamma,198,221523,54277,158405,8841,55926,4631,42325,1440,7530,12161,3141,-372,3395,118,30,1311,-261,-18,1062,-279,198,29006,8677,1037,,7640,0.119511352,2,1116,2
15/09/2020,Alpha-Beta-Gamma,199,225030,55000,161065,8965,56953,4468,43306,1468,7711,12179,3507,723,2660,124,28,981,181,-163,1027,18,189,29195,13090,1048,,12042,0.080061115,1,785,2
16/09/2020,Alpha-Beta-Gamma,200,228993,55792,164101,9100,58458,4802,44251,1498,7907,12709,3963,792,3036,135,30,945,196,334,1505,530,161,29356,13012,1403,,11609,0.107823547,2,2263,3
17/09/2020,Alpha-Beta-Gamma,201,232628,56720,166686,9222,59472,4739,45207,1513,8013,12752,3635,928,2585,122,15,956,106,-63,1014,43,178,29534,13890,1166,,12724,0.083945284,1,933,2
18/09/2020,Alpha-Beta-Gamma,202,236519,56409,170774,9336,60875,4655,46235,1535,8450,13105,3891,-311,4088,114,22,1028,437,-84,1403,353,172,29706,11118,1177,,9941,0.105864364,2,1301,2
19/09/2020,Alpha-Beta-Gamma,203,240687,56889,174350,9448,61807,4305,47260,1546,8696,13001,4168,480,3576,112,11,1025,246,-350,932,-104,205,29911,6818,929,,5889,0.136256967,2,265,2
20/09/2020,Alpha-Beta-Gamma,204,244676,57796,177327,9553,62886,3819,49209,1561,8297,12116,3989,907,2977,105,15,1949,-399,-486,1079,-885,175,30086,14050,1265,,12785,0.090035587,2,152,2
21/09/2020,Alpha-Beta-Gamma,205,248852,58378,180797,9677,64196,3749,49630,1592,9225,12974,4176,582,3470,124,31,421,928,-70,1310,858,164,30250,12368,1187,,11181,0.09597348,2,1263,2
22/09/2020,Alpha-Beta-Gamma,206,252923,58788,184298,9837,65318,3841,50473,1624,9380,13221,4071,410,3501,160,32,843,155,92,1122,247,133,30383,12446,937,,11509,0.075285232,1,1402,2
23/09/2020,Alpha-Beta-Gamma,207,257388,59453,187958,9977,66505,3666,51578,1650,9611,13277,4465,665,3660,140,26,1105,231,-175,1187,56,199,30582,14461,1199,,13262,0.082912662,1,915,2
24/09/2020,Alpha-Beta-Gamma,208,262022,60064,191853,10105,67638,3518,52742,1664,9714,13232,4634,611,3895,128,14,1164,103,-148,1133,-45,163,30745,13100,1253,,11847,0.095648855,2,879,2
25/09/2020,Alpha-Beta-Gamma,209,266845,60431,196196,10218,68927,2871,54352,1677,10027,12898,4823,367,4343,113,13,1610,313,-647,1289,-334,192,30937,12736,1305,,11431,0.102465452,2,34,1
26/09/2020,Alpha-Beta-Gamma,210,271339,61628,199403,10308,70184,2561,55350,1679,10594,13155,4494,1197,3207,90,2,998,567,-310,1257,257,194,31131,6127,807,,5320,0.131712094,2,643,2
27/09/2020,Alpha-Beta-Gamma,211,275213,61813,203014,10386,71370,2350,56413,1692,10915,13265,3874,185,3611,78,13,1063,321,-211,1186,110,193,31324,10211,1204,,9007,0.117912056,2,803,2
28/09/2020,Alpha-Beta-Gamma,212,278722,61379,206870,10473,72177,2258,57741,1704,10474,12732,3509,-434,3856,87,12,1328,-441,-92,807,-533,143,31467,13569,1253,,12316,0.09234284,2,659,2
29/09/2020,Alpha-Beta-Gamma,213,282724,61686,210437,10601,73309,2067,58865,1718,10659,12726,4002,307,3567,128,14,1124,185,-191,1132,-6,159,31626,11914,1141,,10773,0.095769683,2,792,2
30/09/2020,Alpha-Beta-Gamma,214,287008,61321,214947,10740,74368,1964,60320,1731,10353,12317,4284,-365,4510,139,13,1455,-306,-103,1059,-409,181,31807,10648,1103,,9545,0.103587528,2,892,2
01/10/2020,Alpha-Beta-Gamma,215,291182,61839,218487,10856,75521,1795,61444,1737,10545,12340,4174,518,3540,116,6,1124,192,-169,1153,23,180,31987,11800,1110,,10690,0.094067797,2,833,2
02/10/2020,Alpha-Beta-Gamma,216,295499,63187,221340,10972,76619,2104,62279,1740,10496,12600,4317,1348,2853,116,3,835,-49,309,1098,260,190,32177,11265,1141,,10124,0.101287173,2,1725,3
03/10/2020,Alpha-Beta-Gamma,217,299506,63399,225052,11055,77784,2103,63286,1743,10652,12755,4007,212,3712,83,3,1007,156,-1,1165,155,163,32340,5066,696,,4370,0.137386498,2,1172,2
04/10/2020,Alpha-Beta-Gamma,218,303498,63894,228453,11151,79214,2043,64319,1761,11091,13134,3992,495,3401,96,18,1033,439,-60,1430,379,178,32518,10756,1082,,9674,0.100595017,2,1364,2
05/10/2020,Alpha-Beta-Gamma,219,307120,63274,232593,11253,80036,2057,65295,1772,10912,12969,3622,-620,4140,102,11,976,-179,14,822,-165,150,32668,11702,1091,,10611,0.093231926,2,883,2
06/10/2020,Alpha-Beta-Gamma,220,311176,63365,236437,11374,81043,2135,66315,1806,10787,12922,4056,91,3844,121,34,1020,-125,78,1007,-47,139,32807,12335,1140,,11195,0.092419943,2,1265,2
07/10/2020,Alpha-Beta-Gamma,221,315714,63951,240291,11472,82383,2447,67310,1819,10807,13254,4538,586,3854,98,13,995,20,312,1340,332,152,32959,12432,1173,,11259,0.094353282,2,2003,3
08/10/2020,Alpha-Beta-Gamma,222,320564,64924,244060,11580,83392,2485,68352,1838,10717,13202,4850,973,3769,108,19,1042,-90,38,1009,-52,160,33119,12421,1103,,11318,0.088801224,1,1142,2
09/10/2020,Alpha-Beta-Gamma,223,324658,65314,247667,11677,84364,2555,69203,1860,10746,13301,4094,390,3607,97,22,851,29,70,972,99,152,33271,10074,1117,,8957,0.110879492,2,1178,2
10/10/2020,Alpha-Beta-Gamma,224,328952,65706,251481,11765,85617,2555,70487,1877,10698,13253,4294,392,3814,88,17,1284,-48,0,1253,-48,154,33425,7834,893,,6941,0.113990299,2,1304,2
11/10/2020,Alpha-Beta-Gamma,225,333449,66578,255027,11844,87006,2693,71549,1901,10863,13556,4497,872,3546,79,24,1062,165,138,1389,303,155,33580,14336,1612,,12724,0.112444196,2,1737,3
12/10/2020,Alpha-Beta-Gamma,226,336716,66262,258519,11935,88174,2805,72633,1922,10814,13619,3267,-316,3492,91,21,1084,-49,112,1168,63,153,33733,12339,1270,,11069,0.102925683,2,1455,2
13/10/2020,Alpha-Beta-Gamma,227,340622,65299,263296,12027,89228,2643,73733,1944,10908,13551,3906,-963,4777,92,22,1100,94,-162,1054,-68,143,33876,13165,1324,,11841,0.100569692,2,796,2
14/10/2020,Alpha-Beta-Gamma,228,344749,64742,267851,12156,90266,2559,74924,1961,10822,13381,4127,-557,4555,129,17,1191,-86,-84,1038,-170,158,34034,12158,1101,,11057,0.090557658,2,921,2
15/10/2020,Alpha-Beta-Gamma,229,349160,63231,273661,12268,91337,2743,75974,1984,10636,13379,4411,-1511,5810,112,23,1050,-186,184,1071,-2,155,34189,9877,951,,8926,0.096284297,2,1508,2
16/10/2020,Alpha-Beta-Gamma,230,353461,63570,277544,12347,92382,2920,76956,2008,10498,13418,4301,339,3883,79,24,982,-138,177,1045,39,147,34336,8767,913,,7854,0.104140527,2,1471,2
17/10/2020,Alpha-Beta-Gamma,231,357762,63739,281592,12431,93356,2671,78062,2032,10591,13262,4301,169,4048,84,24,1106,93,-249,974,-156,153,34489,5785,667,,5118,0.115298185,2,548,2
18/10/2020,Alpha-Beta-Gamma,232,361867,64032,285324,12511,94327,2358,79136,2051,10782,13140,4105,293,3732,80,19,1074,191,-313,971,-122,138,34627,10070,899,,9171,0.089275074,1,402,2
19/10/2020,Alpha-Beta-Gamma,233,365240,63380,289243,12617,95253,2603,80261,2064,10325,12928,3373,-652,3919,106,13,1125,-457,245,926,-212,163,34790,10412,1002,,9410,0.096235113,2,1455,2
20/10/2020,Alpha-Beta-Gamma,234,368842,62455,293653,12734,96217,2732,81107,2086,10292,13024,3602,-925,4410,117,22,846,-33,129,964,96,136,34926,12520,1094,,11426,0.087380192,1,1288,2
21/10/2020,Alpha-Beta-Gamma,235,373109,62743,297509,12857,97217,2661,82178,2105,10273,12934,4267,288,3856,123,19,1071,-19,-71,1000,-90,148,35074,10631,937,,9694,0.088138463,1,915,2
22/10/2020,Alpha-Beta-Gamma,236,377541,63576,301006,12959,98206,2768,83338,2120,9980,12748,4432,833,3497,102,15,1160,-293,107,989,-186,118,35192,10377,877,,9500,0.084513829,1,1248,2
23/10/2020,Alpha-Beta-Gamma,237,381910,63733,305100,13077,99158,2986,84430,2138,9604,12590,4369,157,4094,118,18,1092,-376,218,952,-158,170,35362,11012,1005,,10007,0.091264076,2,1442,2
24/10/2020,Alpha-Beta-Gamma,238,385980,63556,309219,13205,100220,2924,85586,2153,9557,12481,4070,-177,4119,128,15,1156,-47,-62,1062,-109,158,35520,4701,550,,4151,0.116996384,2,983,2
25/10/2020,Alpha-Beta-Gamma,239,389712,62649,313764,13299,100991,2861,86815,2164,9151,12012,3732,-907,4545,94,11,1229,-406,-63,771,-469,153,35673,10221,842,,9379,0.082379415,1,678,2
26/10/2020,Alpha-Beta-Gamma,240,392934,61851,317672,13411,101897,2775,87977,2185,8960,11735,3222,-798,3908,112,21,1162,-191,-86,906,-277,146,35819,13815,981,,12834,0.071009772,1,797,2
27/10/2020,Alpha-Beta-Gamma,241,396454,60694,322248,13512,102678,2680,89060,2195,8743,11423,3520,-1157,4576,101,10,1083,-217,-95,781,-312,145,35964,10021,803,,9218,0.080131723,1,621,2
28/10/2020,Alpha-Beta-Gamma,242,400483,61078,325793,13612,103522,2716,90157,2211,8438,11154,4029,384,3545,100,16,1097,-305,36,844,-269,124,36088,4932,604,,4328,0.122465531,2,964,2
29/10/2020,Alpha-Beta-Gamma,243,404048,60569,329778,13701,104235,2824,91235,2225,7951,10775,3565,-509,3985,89,14,1078,-487,108,713,-379,140,36228,8870,665,,8205,0.074971815,1,971,2
30/10/2020,Alpha-Beta-Gamma,244,406945,58868,334295,13782,104847,2839,92312,2239,7457,10296,2897,-1701,4517,81,14,1077,-494,15,612,-479,150,36378,7328,668,,6660,0.091157205,2,684,2
31/10/2020,Alpha-Beta-Gamma,245,410088,58418,337801,13869,105597,2384,94434,2255,6524,8908,3143,-450,3506,87,16,2122,-933,-455,750,-1388,141,36519,4199,620,,3579,0.147654203,2,-112,1
01/11/2020,Alpha-Beta-Gamma,246,412784,56899,341942,13943,106205,2178,94819,2273,6935,9113,2696,-1519,4141,74,18,385,411,-206,608,205,130,36649,8215,782,,7433,0.095191722,2,250,2
02/11/2020,Alpha-Beta-Gamma,247,415402,55792,345566,14044,107229,1750,95876,2291,7312,9062,2618,-1107,3624,101,18,1057,377,-428,1024,-51,127,36776,12127,1096,,11031,0.090376845,2,222,2
03/11/2020,Alpha-Beta-Gamma,248,418375,54732,349497,14146,107846,1800,96902,2300,6844,8644,2973,-1060,3931,102,9,1026,-468,50,617,-418,158,36934,12245,1205,,11040,0.098407513,2,744,2
04/11/2020,Alpha-Beta-Gamma,249,421731,54190,353282,14259,108620,1807,97833,2315,6665,8472,3356,-542,3785,113,15,931,-179,7,774,-172,153,37087,10271,1096,,9175,0.106708208,2,833,2
05/11/2020,Alpha-Beta-Gamma,250,425796,54306,357142,14348,109411,2014,98806,2331,6260,8274,4065,116,3860,89,16,973,-405,207,791,-198,135,37222,11151,1069,,10082,0.095865842,2,1253,2
06/11/2020,Alpha-Beta-Gamma,251,429574,54427,360705,14442,110083,1855,99830,2348,6050,7905,3778,121,3563,94,17,1024,-210,-159,672,-369,173,37395,10451,988,,9463,0.094536408,2,405,2
07/11/2020,Alpha-Beta-Gamma,252,433836,54879,364417,14540,111201,1867,100816,2359,6159,8026,4262,452,3712,98,11,986,109,12,1118,121,132,37527,5312,570,,4742,0.107304217,2,1175,2
08/11/2020,Alpha-Beta-Gamma,253,437716,54804,368298,14614,112027,1532,101791,2366,6338,7870,3880,-75,3881,74,7,975,179,-335,826,-156,131,37658,8621,786,,7835,0.091172718,2,177,2
09/11/2020,Alpha-Beta-Gamma,254,440569,53614,372266,14689,112743,1472,102844,2377,6050,7522,2853,-1190,3968,75,11,1053,-288,-60,716,-348,143,37801,13812,1028,,12784,0.074428034,1,629,2
10/11/2020,Alpha-Beta-Gamma,255,444348,53846,375741,14761,113756,1497,104144,2391,5724,7221,3779,232,3475,72,14,1300,-326,25,1013,-301,182,37983,12981,971,,12010,0.074801633,1,1105,2
11/11/2020,Alpha-Beta-Gamma,256,448118,54300,378982,14836,114343,1662,105117,2403,5161,6823,3770,454,3241,75,12,973,-563,165,587,-398,166,38149,13451,1020,,12431,0.075830793,1,953,2
12/11/2020,Alpha-Beta-Gamma,257,452291,55274,382084,14933,115174,1693,106189,2414,4878,6571,4173,974,3102,97,11,1072,-283,31,831,-252,157,38306,10812,987,,9825,0.091287458,2,926,2
13/11/2020,Alpha-Beta-Gamma,258,457735,57604,385094,15037,116207,1604,107147,2428,5028,6632,5444,2330,3010,104,14,958,150,-89,1033,61,177,38483,12651,949,,11702,0.075013833,1,897,2
14/11/2020,Alpha-Beta-Gamma,259,463007,59765,388094,15148,117462,2102,108209,2441,4710,6812,5272,2161,3000,111,13,1062,-318,498,1255,180,170,38653,8081,844,,7237,0.104442519,2,2290,3
15/11/2020,Alpha-Beta-Gamma,260,467113,59911,391991,15211,118627,2046,109181,2448,4952,6998,4106,146,3897,63,7,972,242,-56,1165,186,168,38821,11913,1158,,10755,0.097204734,2,1074,2
16/11/2020,Alpha-Beta-Gamma,261,470648,59909,395443,15296,119633,2537,110221,2455,4420,6957,3535,-2,3452,85,7,1040,-532,491,1006,-41,156,38977,14981,1239,,13742,0.082704759,1,2009,3
17/11/2020,Alpha-Beta-Gamma,262,474455,60426,398636,15393,120671,2761,111096,2459,4355,7116,3807,517,3193,97,4,875,-65,224,1038,159,176,39153,12891,1137,,11754,0.088201071,1,1498,2
18/11/2020,Alpha-Beta-Gamma,263,478720,60870,402347,15503,121818,2781,111948,2470,4619,7400,4265,444,3711,110,11,852,264,20,1147,284,172,39325,13251,1205,,12046,0.090936533,2,1220,2
19/11/2020,Alpha-Beta-Gamma,264,483518,61306,406612,15600,123003,3053,112833,2484,4633,7686,4798,436,4265,97,14,885,14,272,1185,286,169,39494,13988,1216,,12772,0.086931656,1,1771,3
20/11/2020,Alpha-Beta-Gamma,265,488310,62080,410552,15678,124243,3387,113739,2501,4616,8003,4792,774,3940,78,17,906,-17,334,1240,317,167,39661,13781,1144,,12637,0.083012844,1,1959,3
21/11/2020,Alpha-Beta-Gamma,266,493308,63579,413955,15774,125822,3121,114863,2515,5323,8444,4998,1499,3403,96,14,1124,707,-266,1579,441,165,39826,8991,1009,,7982,0.112223334,2,1089,2
22/11/2020,Alpha-Beta-Gamma,267,497668,63596,418188,15884,127164,3165,115939,2531,5529,8694,4360,17,4233,110,16,1076,206,44,1342,250,148,39974,14101,1202,,12899,0.085242181,1,1478,2
23/11/2020,Alpha-Beta-Gamma,268,502110,63722,422386,16002,128173,3030,117003,2548,5592,8622,4442,126,4198,118,17,1064,63,-135,1009,-72,142,40116,17871,1291,,16580,0.072239942,1,790,2
24/11/2020,Alpha-Beta-Gamma,269,506302,64878,425313,16111,129188,3041,118062,2567,5518,8559,4192,1156,2927,109,19,1059,-74,11,1015,-63,149,40265,15381,1124,,14257,0.073077173,1,1094,2
25/11/2020,Alpha-Beta-Gamma,270,511836,65804,429807,16225,130461,2778,119099,2584,6000,8778,5534,926,4494,114,17,1037,482,-263,1273,219,143,40408,15821,1285,,14536,0.081221162,1,798,2
26/11/2020,Alpha-Beta-Gamma,271,516753,66752,433649,16352,131525,2765,120287,2597,5876,8641,4917,948,3842,127,13,1188,-124,-13,1064,-137,160,40568,15122,1320,,13802,0.087290041,1,1077,2
27/11/2020,Alpha-Beta-Gamma,272,522581,68604,437456,16521,132961,2612,121082,2614,6653,9265,5828,1852,3807,169,17,795,777,-153,1436,624,172,40740,14412,1140,,13272,0.079100749,1,1181,2
28/11/2020,Alpha-Beta-Gamma,273,527999,69370,441983,16646,134331,2450,122328,2632,6921,9371,5418,766,4527,125,18,1246,268,-162,1370,106,149,40889,7983,907,,7076,0.113616435,2,1100,2
29/11/2020,Alpha-Beta-Gamma,274,534266,71658,445793,16815,135762,2339,123163,2652,7608,9947,6267,2288,3810,169,20,835,687,-111,1431,576,161,41050,14812,1218,,13594,0.082230624,1,1269,2
30/11/2020,Alpha-Beta-Gamma,275,538883,71420,450518,16945,136861,2289,124078,2671,7823,10112,4617,-238,4725,130,19,915,215,-50,1099,165,167,41217,17812,1248,,16564,0.070065125,1,1056,2
01/12/2020,Alpha-Beta-Gamma,276,543975,72015,454879,17081,137919,2191,125102,2689,7937,10128,5092,595,4361,136,18,1024,114,-98,1058,16,178,41395,14211,1303,,12908,0.091689536,2,916,2
02/12/2020,Alpha-Beta-Gamma,277,549508,73429,458880,17199,139085,2010,126163,2710,8202,10212,5533,1414,4001,118,21,1061,265,-181,1166,84,177,41572,14671,1232,,13439,0.083975189,1,867,2
03/12/2020,Alpha-Beta-Gamma,278,557877,77969,462553,17355,140238,2213,127136,2734,8155,10368,8369,4540,3673,156,24,973,-47,203,1153,156,149,41721,16534,1510,,15024,0.091326963,2,1631,3
04/12/2020,Alpha-Beta-Gamma,279,563680,80023,466178,17479,141270,2389,128051,2757,8073,10462,5803,2054,3625,124,23,915,-82,176,1032,94,139,41860,14671,1168,,13503,0.079612842,1,1453,2
05/12/2020,Alpha-Beta-Gamma,280,569707,81669,470449,17589,142630,2161,129067,2779,8623,10784,6027,1646,4271,110,22,1016,550,-228,1360,322,148,42008,7812,936,,6876,0.119815668,2,970,2
06/12/2020,Alpha-Beta-Gamma,281,575796,83285,474771,17740,143961,2207,130136,2799,8819,11026,6089,1616,4322,151,20,1069,196,46,1331,242,164,42172,15711,1254,,14457,0.079816689,1,1483,2
07/12/2020,Alpha-Beta-Gamma,282,581550,84481,479202,17867,145427,2060,131071,2823,9473,11533,5754,1196,4431,127,24,935,654,-147,1466,507,165,42337,13678,1352,,12326,0.09884486,2,1244,2
08/12/2020,Alpha-Beta-Gamma,283,586842,85345,483497,18000,146601,1861,132248,2842,9650,11511,5292,864,4295,133,19,1177,177,-199,1174,-22,155,42492,15061,1180,,13881,0.078348051,1,833,2
09/12/2020,Alpha-Beta-Gamma,284,592900,87284,487445,18171,147838,1957,133318,2860,9703,11660,6058,1939,3948,171,18,1070,53,96,1237,149,164,42656,16712,1447,,15265,0.08658449,1,1483,2
10/12/2020,Alpha-Beta-Gamma,285,598933,88622,491975,18336,149018,2381,134366,2880,9391,11772,6033,1338,4530,165,20,1048,-312,424,1180,112,159,42815,15921,1346,,14575,0.084542428,1,2088,3
11/12/2020,Alpha-Beta-Gamma,286,605243,89846,496886,18511,150250,2725,135545,2902,9078,11803,6310,1224,4911,175,22,1179,-313,344,1232,31,165,42980,12321,1443,,10878,0.117117117,2,1986,3
12/12/2020,Alpha-Beta-Gamma,287,611631,91602,501376,18653,151201,2968,136489,2922,8822,11790,6388,1756,4490,142,20,944,-256,243,951,-13,158,43138,7121,1190,,5931,0.167111361,2,1497,2
13/12/2020,Alpha-Beta-Gamma,288,617820,93165,505836,18819,152499,3274,137605,2941,8679,11953,6189,1563,4460,166,19,1116,-143,306,1298,163,147,43285,14125,1407,,12718,0.099610619,2,1967,3
14/12/2020,Alpha-Beta-Gamma,289,623309,93396,510957,18956,154065,3120,138988,2963,8994,12114,5489,231,5121,137,22,1383,315,-154,1566,161,181,43466,16123,1675,,14448,0.103888854,2,1324,2
15/12/2020,Alpha-Beta-Gamma,290,629429,93662,516656,19111,155122,3264,140225,2990,8643,11907,6120,266,5699,155,27,1237,-351,144,1057,-207,179,43645,19211,1888,,17323,0.098277029,2,1426,2
16/12/2020,Alpha-Beta-Gamma,291,636154,94922,521984,19248,156343,3705,141365,3010,8263,11968,6725,1260,5328,137,20,1140,-380,441,1221,61,175,43820,21021,1952,,19069,0.092859521,2,2163,3
17/12/2020,Alpha-Beta-Gamma,292,643508,97139,526979,19390,158033,4414,142741,3027,7851,12265,7354,2217,4995,142,17,1376,-412,709,1690,297,176,43996,18100,1772,,16328,0.097900552,2,3159,3
18/12/2020,Alpha-Beta-Gamma,293,650197,98688,531995,19514,159620,4940,143959,3048,7673,12613,6689,1549,5016,124,21,1218,-178,526,1587,348,163,44159,12812,1311,,11501,0.102325944,2,2702,3
19/12/2020,Alpha-Beta-Gamma,294,657948,102029,536260,19659,161519,5273,145066,3068,8112,13385,7751,3341,4265,145,20,1107,439,333,1899,772,152,44311,8314,1151,,7163,0.138441184,2,2625,3
20/12/2020,Alpha-Beta-Gamma,295,664930,103239,541811,19880,163111,5009,146958,3087,8057,13066,6982,1210,5551,221,19,1892,-55,-264,1592,-319,169,44480,17312,2028,,15284,0.117144177,2,1121,2
21/12/2020,Alpha-Beta-Gamma,296,671778,104809,546884,20085,164577,4806,148308,3097,8366,13172,6848,1570,5073,205,10,1350,309,-203,1466,106,188,44668,15524,1652,,13872,0.106415872,2,1090,2
22/12/2020,Alpha-Beta-Gamma,297,678125,105146,552722,20257,165888,4462,149691,3115,8620,13082,6347,337,5838,172,18,1383,254,-344,1311,-90,199,44867,19341,2070,,17271,0.107026524,2,677,2
23/12/2020,Alpha-Beta-Gamma,298,685639,106528,558703,20408,167842,4947,151122,3130,8643,13590,7514,1382,5981,151,15,1431,23,485,1954,508,185,45052,18471,1899,,16572,0.10280981,2,2969,3
24/12/2020,Alpha-Beta-Gamma,299,692838,108269,563980,20589,169775,5305,152491,3146,8833,14138,7199,1741,5277,181,16,1369,190,358,1933,548,204,45256,10882,1881,,9001,0.172854255,2,2697,3
25/12/2020,Alpha-Beta-Gamma,300,700097,108946,570304,20847,171871,5742,154242,3167,8720,14462,7259,677,6324,258,21,1751,-113,437,2096,324,206,45462,10612,1531,,9081,0.144270637,2,3033,3
26/12/2020,Alpha-Beta-Gamma,301,706837,109150,576693,20994,173929,4510,156798,3182,9439,13949,6740,204,6389,147,15,2556,719,-1232,2058,-513,213,45675,10712,1294,,9418,0.120799104,2,-361,1
27/12/2020,Alpha-Beta-Gamma,302,713365,108452,583676,21237,175926,4452,158615,3204,9655,14107,6528,-698,6983,243,22,1817,216,-58,1997,158,217,45892,20216,2181,,18035,0.107884844,2,1947,3
28/12/2020,Alpha-Beta-Gamma,303,719219,107789,589978,21452,177604,4581,159878,3226,9919,14500,5854,-663,6302,215,22,1263,264,129,1678,393,223,46115,20112,2547,,17565,0.126640811,2,2002,3
29/12/2020,Alpha-Beta-Gamma,304,727122,108636,596783,21703,179660,5059,161337,3246,10018,15077,7903,847,6805,251,20,1459,99,478,2056,577,196,46311,19514,2565,,16949,0.131444091,2,3072,3
30/12/2020,Alpha-Beta-Gamma,305,735124,109439,603741,21944,181713,5654,162911,3266,9882,15536,8002,803,6958,241,20,1574,-136,595,2053,459,196,46507,16718,2321,,14397,0.138832396,2,3303,3
31/12/2020,Alpha-Beta-Gamma,306,743198,109963,611097,22138,183735,5821,164881,3287,9746,15567,8074,524,7356,194,21,1970,-136,167,2022,31,185,46692,7812,1281,,6531,0.163978495,2,2419,3
01/01/2021,Alpha-Beta-Gamma,307,751270,111005,617936,22329,185691,5789,166512,3308,10082,15871,8072,1042,6839,191,21,1631,336,-32,1956,304,190,46882,12611,1960,,10651,0.155419872,2,1955,3
02/01/2021,Alpha-Beta-Gamma,308,758473,110400,625518,22555,187586,4599,168781,3334,10872,15471,7203,-605,7582,226,26,2269,790,-1190,1895,-400,191,47073,10391,1671,,8720,0.160812241,2,-407,1
03/01/2021,Alpha-Beta-Gamma,309,765350,110679,631937,22734,189243,4410,170510,3345,10978,15388,6877,279,6419,179,11,1729,106,-189,1657,-83,212,47285,18712,2186,,16526,0.116823429,2,1312,2
04/01/2021,Alpha-Beta-Gamma,310,772103,110089,639103,22911,191075,4299,173036,3369,10371,14670,6753,-590,7166,177,24,2526,-607,-111,1832,-718,202,47487,19123,2420,,16703,0.126549182,2,1682,3
05/01/2021,Alpha-Beta-Gamma,311,779548,110693,645746,23109,192899,4479,174131,3392,10897,15376,7445,604,6643,198,23,1095,526,180,1824,706,198,47685,22131,2481,,19650,0.112105192,2,2253,3
06/01/2021,Alpha-Beta-Gamma,312,788402,112593,652513,23296,195301,4254,175441,3410,12196,16450,8854,1900,6767,187,18,1310,1299,-225,2402,1074,238,47923,20011,2834,,17177,0.141622108,2,2006,3
07/01/2021,Alpha-Beta-Gamma,313,797723,114766,659437,23520,197699,4601,176882,3435,12781,17382,9321,2173,6924,224,25,1441,585,347,2398,932,211,48134,20471,2774,,17697,0.135508769,2,3167,3
08/01/2021,Alpha-Beta-Gamma,314,808340,117704,666883,23753,200658,4236,179562,3463,13397,17633,10617,2938,7446,233,28,2680,616,-365,2959,251,234,48368,17512,2892,,14620,0.165143901,2,2313,3
09/01/2021,Alpha-Beta-Gamma,315,818386,120928,673511,23947,203411,5237,181613,3485,13076,18313,10046,3224,6628,194,22,2051,-321,1001,2753,680,243,48611,10312,2346,,7966,0.227501939,2,4821,3
10/01/2021,Alpha-Beta-Gamma,316,828026,122873,681024,24129,206122,4863,184576,3517,13166,18029,9640,1945,7513,182,32,2963,90,-374,2711,-284,194,48805,14715,2869,,11846,0.194971118,2,2059,3
11/01/2021,Alpha-Beta-Gamma,317,836718,123636,688739,24343,208583,4405,187086,3551,13541,17946,8692,763,7715,214,34,2510,375,-458,2461,-83,229,49034,16312,3088,,13224,0.189308485,2,1647,3
12/01/2021,Alpha-Beta-Gamma,318,846765,126313,695807,24645,211252,4397,188675,3589,14591,18988,10047,2677,7068,302,38,1589,1050,-8,2669,1042,223,49257,19121,3214,,15907,0.168087443,2,2767,3
13/01/2021,Alpha-Beta-Gamma,319,858043,129628,703464,24951,214728,4450,191635,3634,15009,19459,11278,3315,7657,306,45,2960,418,53,3476,471,231,49488,20982,2759,,18223,0.131493661,2,3717,3
14/01/2021,Alpha-Beta-Gamma,320,869600,133149,711205,25246,217893,4647,193719,3675,15852,20499,11557,3521,7741,295,41,2084,843,197,3165,1040,206,49694,22812,3217,,19595,0.141022269,2,3682,3
15/01/2021,Alpha-Beta-Gamma,321,882418,138238,718696,25484,220434,5247,195924,3710,15553,20800,12818,5089,7491,238,35,2205,-299,600,2541,301,210,49904,17617,2559,,15058,0.145257422,2,3846,3
16/01/2021,Alpha-Beta-Gamma,322,896642,143517,727358,25767,223970,4565,198136,3745,17524,22089,14224,5279,8662,283,35,2212,1971,-682,3536,1289,225,50129,12813,2361,,10452,0.18426598,2,2277,3
17/01/2021,Alpha-Beta-Gamma,323,907929,145482,736460,25987,227365,4938,201907,3779,16741,21679,11287,1965,9102,220,34,3771,-783,373,3395,-410,225,50354,20101,2839,,17262,0.141236754,2,4243,3
18/01/2021,Alpha-Beta-Gamma,324,917015,144798,745935,26282,229726,4781,204711,3815,16419,21200,9086,-684,9475,295,36,2804,-322,-157,2361,-479,214,50568,20812,3126,,17686,0.150201807,2,2155,3
19/01/2021,Alpha-Beta-Gamma,325,927380,146842,753948,26590,232289,4611,209238,3836,14604,19215,10365,2044,8013,308,21,4527,-1815,-170,2563,-1985,222,50790,23411,3174,,20237,0.135577293,2,2286,3
20/01/2021,Alpha-Beta-Gamma,326,939948,149388,763703,26857,236075,4835,210983,3868,16389,21224,12568,2546,9755,267,32,1745,1785,224,3786,2009,217,51007,24312,3719,,20593,0.152969727,2,4330,3
21/01/2021,Alpha-Beta-Gamma,327,951651,151658,772790,27203,239226,4790,213570,3900,16966,21756,11703,2270,9087,346,32,2587,577,-45,3151,532,214,51221,22812,3350,,19462,0.146852534,2,3157,3
22/01/2021,Alpha-Beta-Gamma,328,965283,156683,781147,27453,243018,5607,215719,3940,17752,23359,13632,5025,8357,250,40,2149,786,817,3792,1603,177,51398,18612,3612,,15000,0.194068343,2,5546,3
23/01/2021,Alpha-Beta-Gamma,329,977474,158751,791059,27664,246303,4379,219287,3980,18657,23036,12191,2068,9912,211,40,3568,905,-1228,3285,-323,208,51606,16788,2572,,14216,0.15320467,2,949,2
24/01/2021,Alpha-Beta-Gamma,330,989262,162617,798810,27835,249815,4670,221567,4024,19554,24224,11788,3866,7751,171,44,2280,897,291,3512,1188,201,51807,17812,2038,,15774,0.114417247,2,4226,3
25/01/2021,Alpha-Beta-Gamma,331,999256,161636,809488,28132,252266,4263,224071,4063,19869,24132,9994,-981,10678,297,39,2504,315,-407,2451,-92,196,52003,19012,2136,,16876,0.112350095,2,1754,3
26/01/2021,Alpha-Beta-Gamma,332,1012350,163526,820356,28468,254580,4030,227010,4108,19432,23462,13094,1890,10868,336,45,2939,-437,-233,2314,-670,237,52240,20188,3026,,17162,0.149891024,2,1983,3
27/01/2021,Alpha-Beta-Gamma,333,1024298,164113,831330,28855,256416,3773,229981,4134,18528,22301,11948,587,10974,387,26,2971,-904,-257,1836,-1161,203,52443,21923,3143,,18780,0.143365415,2,1400,2
28/01/2021,Alpha-Beta-Gamma,334,1037993,166540,842122,29331,259305,3946,232701,4185,18473,22419,13695,2427,10792,476,51,2720,-55,173,2889,118,218,52661,20312,3160,,17152,0.15557306,2,3388,3
29/01/2021,Alpha-Beta-Gamma,335,1051795,170017,852260,29518,262753,4008,235140,4224,19381,23389,13802,3477,10138,187,39,2439,908,62,3448,970,175,52836,18451,3474,,14977,0.188282478,2,3689,3
30/01/2021,Alpha-Beta-Gamma,336,1066313,174083,862502,29728,266244,3056,238395,4254,20539,23595,14518,4066,10242,210,30,3255,1158,-952,3491,206,199,53035,10312,3102,,7210,0.300814585,3,1677,3
31/01/2021,Alpha-Beta-Gamma,337,1078314,175095,873221,29998,269718,4110,242069,4267,19272,23382,12001,1012,10719,270,13,3674,-1267,1054,3474,-213,171,53206,16217,3362,,12855,0.207313313,2,5621,3
01/02/2021,Alpha-Beta-Gamma,338,1089308,175349,883682,30277,273332,4969,244202,4337,19824,24793,10994,254,10461,279,70,2133,552,859,3614,1411,192,53398,18121,3567,,14554,0.196843441,2,5542,3
02/02/2021,Alpha-Beta-Gamma,339,1099687,172576,896530,30581,276694,4875,248515,4379,18925,23800,10379,-2773,12848,304,42,4313,-899,-94,3362,-993,198,53596,17875,3632,,14243,0.203188811,2,3300,3
03/02/2021,Alpha-Beta-Gamma,340,1111671,175236,905665,30770,280261,4168,249810,4420,21863,26031,11984,2660,9135,189,41,1295,2938,-707,3567,2231,201,53797,19593,3340,,16253,0.170469045,2,2276,3
04/02/2021,Alpha-Beta-Gamma,341,1123105,175068,917036,31001,283893,4858,254155,4461,20419,25277,11434,-168,11371,231,41,4345,-1444,690,3632,-754,176,53973,17290,2379,,14911,0.137593985,2,5135,3
05/02/2021,Alpha-Beta-Gamma,342,1134854,176672,926980,31202,287233,4838,256702,4502,21191,26029,11749,1604,9944,201,41,2547,772,-20,3340,752,209,54182,17758,4213,,13545,0.237245185,2,3423,3
06/02/2021,Alpha-Beta-Gamma,343,1147010,176433,939184,31393,289612,4719,261027,4541,19325,24044,12156,-239,12204,191,39,4325,-1866,-119,2379,-1985,185,54367,10197,3144,,7053,0.308325978,3,2258,3
07/02/2021,Alpha-Beta-Gamma,344,1157837,176291,949990,31556,293825,5911,265369,4587,17958,23869,10827,-142,10806,163,46,4342,-1367,1192,4213,-175,163,54530,16061,3437,,12624,0.213996638,2,6735,3
08/02/2021,Alpha-Beta-Gamma,345,1166079,171288,963028,31763,296969,5787,268785,4631,17766,23553,8242,-5003,13038,207,44,3416,-192,-124,3144,-316,168,54698,17660,3309,,14351,0.187372593,2,3028,3
09/02/2021,Alpha-Beta-Gamma,346,1174779,169351,973452,31976,300406,5978,271573,4681,18174,24152,8700,-1937,10424,213,50,2788,408,191,3437,599,194,54892,16571,2514,,14057,0.15171082,2,3969,3
10/02/2021,Alpha-Beta-Gamma,347,1183555,168416,982972,32167,303715,7497,274817,4725,16676,24173,8776,-935,9520,191,44,3244,-1498,1519,3309,21,203,55095,17319,3810,,13509,0.219989607,2,6479,3
11/02/2021,Alpha-Beta-Gamma,348,1191990,166492,993117,32381,306229,8540,278822,4748,14119,22659,8435,-1924,10145,214,23,4005,-2557,1043,2514,-1514,175,55270,11203,3018,,8185,0.269392127,3,4669,3
12/02/2021,Alpha-Beta-Gamma,349,1201859,165086,1004117,32656,310039,9888,284579,4798,10774,20662,9869,-1406,11000,275,50,5757,-3345,1348,3810,-1997,186,55456,13524,2496,,11028,0.184560781,2,6656,3
13/02/2021,Alpha-Beta-Gamma,350,1210703,161731,1016036,32936,313057,9374,289189,4850,9644,19018,8844,-3355,11919,280,52,4610,-1130,-514,3018,-1644,180,55636,8239,1879,,6360,0.228061658,2,2146,3
14/02/2021,Alpha-Beta-Gamma,351,1217468,159012,1025273,33183,315553,8103,293538,4895,9017,17120,6765,-2719,9237,247,45,4349,-627,-1271,2496,-1898,148,55784,10681,1861,,8820,0.174234622,2,89,1
15/02/2021,Alpha-Beta-Gamma,352,1223930,158498,1032065,33367,317432,7988,295623,4940,8881,16869,6462,-514,6792,184,45,2085,-136,-115,1879,-251,174,55958,9306,1445,,7861,0.155276166,2,1784,3
16/02/2021,Alpha-Beta-Gamma,353,1233959,160689,1039674,33596,319293,7569,297695,4987,9042,16611,10029,2191,7609,229,47,2072,161,-419,1861,-258,192,56150,9107,373,,8734,0.040957505,1,1164,2
17/02/2021,Alpha-Beta-Gamma,354,1243646,162182,1047676,33788,320738,7450,299795,5026,8467,15917,9687,1493,8002,192,39,2100,-575,-119,1445,-694,175,56325,15973,1920,,14053,0.120202842,2,1324,2
18/02/2021,Alpha-Beta-Gamma,355,1252685,160494,1058222,33969,321111,6549,302451,5044,7067,13616,9039,-1688,10546,181,18,2656,-1400,-901,373,-2301,179,56504,12292,2872,,9420,0.233647901,2,-1375,1
19/02/2021,Alpha-Beta-Gamma,356,1263299,160142,1069005,34152,323031,5632,304995,5081,7323,12955,10614,-352,10783,183,37,2544,256,-917,1920,-661,179,56683,13045,2720,,10325,0.208509007,2,197,2
20/02/2021,Alpha-Beta-Gamma,357,1271353,158197,1078840,34316,325903,5858,307759,5121,7165,13023,8054,-1945,9835,164,40,2764,-158,226,2872,68,157,56840,9312,2471,,6841,0.265356529,3,3444,3
21/02/2021,Alpha-Beta-Gamma,358,1278653,157088,1087076,34489,328623,5902,310412,5172,7137,13039,7300,-1109,8236,173,51,2653,-28,44,2720,16,170,57010,11429,782,,10647,0.068422434,1,2961,3
22/02/2021,Alpha-Beta-Gamma,359,1288833,157148,1096994,34691,331094,5612,312748,5206,7528,13140,10180,60,9918,202,34,2336,391,-290,2471,101,166,57176,14002,782,,13220,0.055849164,1,1993,3
23/02/2021,Alpha-Beta-Gamma,360,1298608,158604,1104990,35014,331876,4939,314563,5248,7126,12065,9775,1456,7996,323,42,1815,-402,-673,782,-1075,159,57335,15038,1581,,13457,0.105133661,2,-438,1
24/02/2021,Alpha-Beta-Gamma,361,1306141,158162,1112725,35254,332658,4346,317003,5301,6008,10354,7533,-442,7735,240,53,2440,-1118,-593,782,-1711,156,57491,13802,1661,,12141,0.120344878,2,-245,1
25/02/2021,Alpha-Beta-Gamma,362,1314634,157705,1121411,35518,334239,4068,319326,5346,5499,9567,8493,-457,8686,264,45,2323,-509,-278,1581,-787,171,57662,13432,1737,,11695,0.129318046,2,1160,2
26/02/2021,Alpha-Beta-Gamma,363,1322866,158408,1128672,35786,335900,3917,321038,5385,5560,9477,8232,703,7261,268,39,1712,61,-151,1661,-90,146,57808,12559,2098,,10461,0.167051517,2,1476,2
27/02/2021,Alpha-Beta-Gamma,364,1329074,157039,1136054,35981,337637,4028,322285,5439,5885,9913,6208,-1369,7382,195,54,1247,325,111,1737,436,150,57958,7797,2058,,5739,0.263947672,3,2121,3
28/02/2021,Alpha-Beta-Gamma,365,1334634,155765,1142703,36166,339735,4425,323892,5478,5940,10365,5560,-1274,6649,185,39,1607,55,397,2098,452,180,58138,10394,578,,9816,0.055609005,1,3009,3
01/03/2021,Alpha-Beta-Gamma,366,1341314,153074,1151915,36325,341793,3865,326509,5528,5891,9756,6680,-2691,9212,159,50,2617,-49,-560,2058,-609,176,58314,20538,1437,,19101,0.069967864,1,1088,2
02/03/2021,Alpha-Beta-Gamma,367,1347026,149645,1160863,36518,342371,3205,328526,5568,5072,8277,5712,-3429,8948,193,40,2017,-819,-660,578,-1479,159,58473,14072,2008,,12064,0.142694713,2,-622,1
03/03/2021,Alpha-Beta-Gamma,368,1353834,147197,1169916,36721,343808,3437,331016,5613,3742,7179,6808,-2448,9053,203,45,2490,-1330,232,1437,-1098,169,58642,12608,1159,,11449,0.091925761,2,2036,3
04/03/2021,Alpha-Beta-Gamma,369,1361098,147845,1176356,36897,345816,3461,332758,5657,3940,7401,7264,648,6440,176,44,1742,198,24,2008,222,166,58808,8787,1616,,7171,0.183908046,2,2188,3
05/03/2021,Alpha-Beta-Gamma,370,1368093,148380,1182687,37026,346975,3147,334100,5702,4026,7173,6995,535,6331,129,45,1342,86,-314,1159,-228,142,58950,8261,1834,,6427,0.222007021,2,666,2
06/03/2021,Alpha-Beta-Gamma,371,1373836,147172,1189510,37154,348591,2998,335617,5748,4228,7226,5743,-1208,6823,128,46,1517,202,-149,1616,53,152,59102,11041,1783,,9258,0.161488996,2,1456,2
07/03/2021,Alpha-Beta-Gamma,372,1379662,147740,1194656,37266,350425,3015,337426,5790,4194,7209,5826,568,5146,112,42,1809,-34,17,1834,-17,125,59227,12172,867,,11305,0.07122905,1,1994,3
08/03/2021,Alpha-Beta-Gamma,373,1386556,145628,1203381,37547,352208,2945,338931,5838,4494,7439,6894,-2112,8725,281,48,1505,300,-70,1783,230,163,59390,13813,1040,,12773,0.075291392,1,1787,3
09/03/2021,Alpha-Beta-Gamma,374,1392945,144311,1210877,37757,353075,2749,340587,5883,3856,6605,6389,-1317,7496,210,45,1656,-638,-196,867,-834,146,59536,14611,1754,,12857,0.12004654,2,610,2
10/03/2021,Alpha-Beta-Gamma,375,1398578,144213,1216433,37932,354115,3103,341398,5923,3691,6794,5633,-98,5556,175,40,811,-165,354,1040,189,149,59685,12062,1873,,10189,0.155281048,2,1868,3
11/03/2021,Alpha-Beta-Gamma,376,1403722,141070,1224603,38049,355869,3367,342306,5943,4253,7620,5144,-3143,8170,117,20,908,562,264,1754,826,133,59818,11376,1034,,10342,0.090893108,2,2342,3
12/03/2021,Alpha-Beta-Gamma,377,1410134,140451,1231454,38229,357742,3752,343351,5969,4670,8422,6412,-619,6851,180,26,1045,417,385,1873,802,173,59991,11932,1204,,10728,0.100905129,2,2721,3
13/03/2021,Alpha-Beta-Gamma,378,1414741,138942,1237470,38329,358776,3357,345202,5991,4226,7583,4607,-1509,6016,100,22,1851,-444,-395,1034,-839,156,60147,9342,1555,,7787,0.16645258,2,310,2
14/03/2021,Alpha-Beta-Gamma,379,1419455,137912,1243117,38426,359980,3301,347210,6026,3443,6744,4714,-1030,5647,97,35,2008,-783,-56,1204,-839,123,60270,15239,835,,14404,0.054793622,1,1197,2
15/03/2021,Alpha-Beta-Gamma,380,1425044,136524,1249947,38573,361535,3010,349002,6038,3485,6495,5589,-1388,6830,147,12,1792,42,-291,1555,-249,153,60423,13736,1330,,12406,0.096825859,2,1009,2
16/03/2021,Alpha-Beta-Gamma,381,1430458,134042,1257663,38753,362370,2751,350561,6062,2996,5747,5414,-2482,7716,180,24,1559,-489,-259,835,-748,152,60575,15107,1719,,13388,0.11378831,2,389,2
17/03/2021,Alpha-Beta-Gamma,382,1437283,131695,1266673,38915,363700,3036,351680,6077,2907,5943,6825,-2347,9010,162,15,1119,-89,285,1330,196,177,60752,11497,1588,,9909,0.138122989,2,1945,3
18/03/2021,Alpha-Beta-Gamma,383,1443853,131753,1272958,39142,365419,3219,352827,6100,3273,6492,6570,58,6285,227,23,1147,366,183,1719,549,172,60924,13204,1937,,11267,0.14669797,2,2154,3
19/03/2021,Alpha-Beta-Gamma,384,1450132,131828,1278965,39339,367007,3368,354036,6120,3483,6851,6279,75,6007,197,20,1209,210,149,1588,359,173,61097,10562,1638,,8924,0.155084264,2,1946,3
20/03/2021,Alpha-Beta-Gamma,385,1455788,131616,1284725,39447,368944,3686,355221,6143,3894,7580,5656,-212,5760,108,23,1185,411,318,1937,729,137,61234,8728,1474,,7254,0.16888176,2,2642,3
21/03/2021,Alpha-Beta-Gamma,386,1460184,129844,1290790,39550,370582,3463,357100,6160,3859,7322,4396,-1772,6065,103,17,1879,-35,-223,1638,-258,166,61400,10242,815,,9427,0.079574302,1,1243,2
22/03/2021,Alpha-Beta-Gamma,387,1465928,128250,1297967,39711,372056,3276,358826,6179,3775,7051,5744,-1594,7177,161,19,1726,-84,-187,1474,-271,154,61554,16096,890,,15206,0.055293241,1,1157,2
23/03/2021,Alpha-Beta-Gamma,388,1471225,126439,1304921,39865,372871,3079,360479,6206,3107,6186,5297,-1811,6954,154,27,1653,-668,-197,815,-865,161,61715,12742,1726,,11016,0.135457542,2,502,2
24/03/2021,Alpha-Beta-Gamma,389,1476452,123926,1312543,39983,373761,2639,362248,6224,2650,5289,5227,-2513,7622,118,18,1769,-457,-440,890,-897,156,61871,13080,1381,,11699,0.10558104,2,64,1
25/03/2021,Alpha-Beta-Gamma,390,1482559,125279,1317199,40081,375487,3049,362975,6241,3222,6271,6107,1353,4656,98,17,727,572,410,1726,982,164,62035,13086,1354,,11732,0.103469357,2,2597,3
26/03/2021,Alpha-Beta-Gamma,391,1487541,124497,1322878,40166,376868,3380,363599,6260,3629,7009,4982,-782,5679,85,19,624,407,331,1381,738,131,62166,12292,1470,,10822,0.119589977,2,2100,3
27/03/2021,Alpha-Beta-Gamma,392,1492002,124517,1327121,40364,378222,3758,364251,6281,3932,7690,4461,20,4243,198,21,652,303,378,1354,681,146,62312,7497,1014,,6483,0.135254102,2,2173,3
28/03/2021,Alpha-Beta-Gamma,393,1496085,124236,1331400,40449,379692,3830,365592,6304,3966,7796,4083,-281,4279,85,23,1341,34,72,1470,106,158,62470,11412,384,,11028,0.033648791,1,1683,3
29/03/2021,Alpha-Beta-Gamma,394,1501093,123694,1336818,40581,380706,3733,366615,6324,4034,7767,5008,-542,5418,132,20,1023,68,-97,1014,-29,151,62621,13420,965,,12455,0.071907601,1,880,2
30/03/2021,Alpha-Beta-Gamma,395,1505775,122326,1342695,40754,381090,3525,367819,6327,3419,6944,4682,-1368,5877,173,3,1204,-615,-208,384,-823,130,62751,12124,1337,,10787,0.110277136,2,-23,1
31/03/2021,Alpha-Beta-Gamma,396,1511712,122524,1348330,40858,382055,3679,369007,6341,3028,6707,5937,198,5635,104,14,1188,-391,154,965,-237,151,62902,11141,1240,,9901,0.111300601,2,1315,2
01/04/2021,Alpha-Beta-Gamma,397,1517854,121222,1355578,41054,383392,3672,369929,6344,3447,7119,6142,-1302,7248,196,3,922,419,-7,1337,412,135,63037,7516,1098,,6418,0.146088345,2,1332,2
02/04/2021,Alpha-Beta-Gamma,398,1523179,121011,1361017,41151,384632,3594,371254,6351,3433,7027,5325,-211,5439,97,7,1325,-14,-78,1240,-92,152,63189,7694,736,,6958,0.095658955,2,1105,2
03/04/2021,Alpha-Beta-Gamma,399,1527524,120068,1366214,41242,385730,3563,372494,6356,3317,6880,4345,-943,5197,91,5,1240,-116,-31,1098,-147,151,63340,7333,523,,6810,0.071321424,1,1051,2
04/04/2021,Alpha-Beta-Gamma,400,1534255,116709,1375877,41669,386466,3392,373565,6360,3149,6541,6731,-3359,9663,427,4,1071,-168,-171,736,-339,137,63477,12620,487,,12133,0.03858954,1,406,2
05/04/2021,Alpha-Beta-Gamma,401,1537967,114475,1381677,41815,386989,3304,374542,6372,2771,6075,3712,-2234,5800,146,12,977,-378,-88,523,-466,140,63617,12096,862,,11234,0.071263228,1,383,2
06/04/2021,Alpha-Beta-Gamma,402,1542516,114566,1385973,41977,387476,3312,375080,6379,2705,6017,4549,91,4296,162,7,538,-66,8,487,-58,130,63747,9603,1239,,8364,0.129022181,2,524,2
07/04/2021,Alpha-Beta-Gamma,403,1547376,113570,1391742,42064,388338,3482,375651,6391,2814,6296,4860,-996,5769,87,12,571,109,170,862,279,147,63894,10548,1013,,9535,0.096037163,2,1238,2
08/04/2021,Alpha-Beta-Gamma,404,1552880,111271,1399382,42227,389577,3653,376270,6410,3244,6897,5504,-2299,7640,163,19,619,430,171,1239,601,139,64033,10442,977,,9465,0.093564451,2,1638,3
09/04/2021,Alpha-Beta-Gamma,405,1558145,110118,1405679,42348,390590,3701,376959,6424,3506,7207,5265,-1153,6297,121,14,689,262,48,1013,310,141,64174,8868,1031,,7837,0.116260713,2,1151,2
10/04/2021,Alpha-Beta-Gamma,406,1562868,111137,1409288,42443,391567,3619,377797,6435,3716,7335,4723,1019,3609,95,11,838,210,-82,977,128,155,64329,7265,692,,6573,0.095251204,2,846,2
11/04/2021,Alpha-Beta-Gamma,407,1566995,109958,1414507,42530,392598,3321,379210,6450,3617,6938,4127,-1179,5219,87,15,1413,-99,-298,1031,-397,148,64477,7576,828,,6748,0.109292503,2,480,2
12/04/2021,Alpha-Beta-Gamma,408,1571824,109372,1419796,42656,393290,2947,380560,6459,3324,6271,4829,-586,5289,126,9,1350,-293,-374,692,-667,151,64628,12934,661,,12273,0.051105613,1,-29,1
13/04/2021,Alpha-Beta-Gamma,409,1577526,108599,1426145,42782,394118,2861,381449,6482,3326,6187,5702,-773,6349,126,23,889,2,-86,828,-84,127,64755,10673,1330,,9343,0.124613511,2,725,2
14/04/2021,Alpha-Beta-Gamma,410,1583182,108384,1431892,42906,394779,2861,382091,6489,3338,6199,5656,-215,5747,124,7,642,12,0,661,12,152,64907,11191,979,,10212,0.087481012,1,682,2
15/04/2021,Alpha-Beta-Gamma,411,1589359,108032,1438254,43073,396109,3067,382617,6504,3921,6988,6177,-352,6362,167,15,526,583,206,1330,789,142,65049,10823,1037,,9786,0.095814469,2,1787,3
16/04/2021,Alpha-Beta-Gamma,412,1594722,107297,1444229,43196,397088,3313,383655,6513,3607,6920,5363,-735,5975,123,9,1038,-314,246,979,-68,131,65180,6749,950,,5799,0.140761594,2,1498,2
17/04/2021,Alpha-Beta-Gamma,413,1599763,106243,1450192,43328,398125,3441,384652,6520,3512,6953,5041,-1054,5963,132,7,997,-95,128,1037,33,156,65336,8565,973,,7592,0.113601868,2,1314,2
18/04/2021,Alpha-Beta-Gamma,414,1604348,105859,1455065,43424,399075,3611,385615,6536,3313,6924,4585,-384,4873,96,16,963,-199,170,950,-29,108,65444,8601,460,,8141,0.053482153,1,1338,2
19/04/2021,Alpha-Beta-Gamma,415,1609300,104319,1461414,43567,400048,3666,386606,6558,3218,6884,4952,-1540,6349,143,22,991,-95,55,973,-40,153,65597,11434,602,,10832,0.052649991,1,1149,2
20/04/2021,Alpha-Beta-Gamma,416,1614849,102930,1468142,43777,400508,3487,387507,6569,2945,6432,5549,-1389,6728,210,11,901,-273,-179,460,-452,142,65739,10519,1266,,9253,0.120353646,2,135,2
21/04/2021,Alpha-Beta-Gamma,417,1620569,101106,1475456,44007,401110,3486,388083,6587,2954,6440,5720,-1824,7314,230,18,576,9,-1,602,8,134,65873,8671,884,,7787,0.101949025,2,654,2
22/04/2021,Alpha-Beta-Gamma,418,1626812,101191,1481449,44172,402376,3548,388735,6596,3497,7045,6243,85,5993,165,9,652,543,62,1266,605,130,66003,9747,907,,8840,0.093054273,2,1417,2
23/04/2021,Alpha-Beta-Gamma,419,1632248,100533,1487369,44346,403260,3619,389445,6612,3584,7203,5436,-658,5920,174,16,710,87,71,884,158,111,66114,7851,896,,6955,0.114125589,2,1074,2
24/04/2021,Alpha-Beta-Gamma,420,1636792,99970,1492322,44500,404167,3647,390334,6623,3563,7210,4544,-563,4953,154,11,889,-21,28,907,7,135,66249,6846,749,,6097,0.109406953,2,996,2
25/04/2021,Alpha-Beta-Gamma,421,1641194,100474,1496126,44594,405063,3718,391301,6645,3399,7117,4402,504,3804,94,22,967,-164,71,896,-93,123,66372,7856,393,,7463,0.050025458,1,1104,2
26/04/2021,Alpha-Beta-Gamma,422,1647138,100652,1501715,44770,405812,3405,392595,6660,3152,6557,5944,178,5589,176,15,1294,-247,-313,749,-560,142,66514,10830,639,,10191,0.05900277,1,168,2
27/04/2021,Alpha-Beta-Gamma,423,1651794,100256,1506599,44939,406205,3322,393205,6679,2999,6321,4656,-396,4884,169,19,610,-153,-83,393,-236,148,66662,9559,987,,8572,0.103253478,2,284,2
28/04/2021,Alpha-Beta-Gamma,424,1657035,100502,1511417,45116,406844,3390,393814,6690,2950,6340,5241,246,4818,177,11,609,-49,68,639,19,147,66809,9712,789,,8923,0.081239703,1,808,2
29/04/2021,Alpha-Beta-Gamma,425,1662868,100102,1517432,45334,407831,3410,394403,6710,3308,6718,5833,-400,6015,218,20,589,358,20,987,378,131,66940,9962,926,,9036,0.092953222,2,1087,2
30/04/2021,Alpha-Beta-Gamma,426,1668368,100213,1522634,45521,408620,3527,394939,6733,3421,6948,5500,111,5202,187,23,536,113,117,789,230,117,67057,6957,854,,6103,0.122754061,2,1092,2
01/05/2021,Alpha-Beta-Gamma,427,1672880,100250,1526978,45652,409546,3622,395644,6747,3533,7155,4512,37,4344,131,14,705,112,95,926,207,123,67180,6765,757,,6008,0.111899483,2,1158,2
02/05/2021,Alpha-Beta-Gamma,428,1677274,100760,1530718,45796,410400,3589,396594,6767,3450,7039,4394,510,3740,144,20,950,-83,-33,854,-116,165,67345,8154,416,,7738,0.051017905,1,848,2
03/05/2021,Delta,1,1682004,100564,1535491,45949,411157,3537,397349,6788,3483,7020,4730,-196,4773,153,21,755,33,-52,757,-19,129,67474,10686,845,,9841,0.079075426,1,716,2
04/05/2021,Delta,2,1686373,99087,1541149,46137,411573,3564,397955,6807,3247,6811,4369,-1477,5658,188,19,606,-236,27,416,-209,150,67624,11480,905,,10575,0.078832753,1,527,2
05/05/2021,Delta,3,1691658,98217,1547092,46349,412418,3738,398610,6830,3240,6978,5285,-870,5943,212,23,655,-7,174,845,167,134,67758,10752,783,,9969,0.072823661,1,1262,2
06/05/2021,Delta,4,1697305,98277,1552532,46496,413323,3843,399224,6850,3406,7249,5647,60,5440,147,20,614,166,105,905,271,123,67881,9612,732,,8880,0.076154806,1,1175,2
07/05/2021,Delta,5,1703632,98546,1558423,46663,414106,3928,399821,6872,3485,7413,6327,269,5891,167,22,597,79,85,783,164,123,68004,8206,809,,7397,0.0985864,2,1019,2
08/05/2021,Delta,6,1709762,99003,1563917,46842,414838,3970,400403,6896,3569,7539,6130,457,5494,179,24,582,84,42,732,126,128,68132,6910,694,,6216,0.100434153,2,888,2
09/05/2021,Delta,7,1713684,98395,1568277,47012,415647,3974,401114,6911,3648,7622,3922,-608,4360,170,15,711,79,4,809,83,116,68248,6139,406,,5733,0.06613455,1,862,2
10/05/2021,Delta,8,1718575,96742,1574615,47218,416341,3941,401744,6933,3723,7664,4891,-1653,6338,206,22,630,75,-33,694,42,127,68375,8182,656,,7526,0.080175996,1,694,2
11/05/2021,Delta,9,1723596,95924,1580207,47465,416747,3931,402374,6952,3490,7421,5021,-818,5592,247,19,630,-233,-10,406,-243,154,68529,8229,785,,7444,0.095394337,2,443,2
12/05/2021,Delta,10,1728204,95709,1584878,47617,417403,3989,403039,6973,3402,7391,4608,-215,4671,152,21,665,-88,58,656,-30,150,68679,4590,632,,3958,0.137690632,2,835,2
13/05/2021,Delta,11,1731652,94857,1589079,47716,418188,3955,403630,6973,3630,7585,3448,-852,4201,99,0,591,228,-34,785,194,132,68811,4032,227,,3805,0.056299603,1,717,2
14/05/2021,Delta,12,1734285,93576,1592886,47823,418820,4128,404187,7003,3502,7630,2633,-1281,3807,107,30,557,-128,173,632,45,150,68961,3580,161,,3419,0.044972067,1,1068,2
15/05/2021,Delta,13,1736670,91636,1597067,47967,419047,3978,404715,7066,3288,7266,2385,-1940,4181,144,63,528,-214,-150,227,-364,143,69104,4361,421,,3940,0.096537491,2,116,1
16/05/2021,Delta,14,1739750,90800,1600857,48093,419208,3957,404980,7082,3189,7146,3080,-836,3790,126,16,265,-99,-21,161,-120,124,69228,4131,291,,3840,0.070442992,1,167,2
17/05/2021,Delta,15,1744045,89129,1606611,48305,419629,4135,405229,7107,3158,7293,4295,-1671,5754,212,25,249,-31,178,421,147,116,69344,4494,539,,3955,0.119937695,2,852,2
18/05/2021,Delta,16,1748230,87514,1612239,48477,419920,4185,405357,7130,3248,7433,4185,-1615,5628,172,23,128,90,50,291,140,112,69456,8307,895,,7412,0.10774046,2,460,2
19/05/2021,Delta,17,1753101,87829,1616603,48669,420459,4409,405535,7149,3366,7775,4871,315,4364,192,19,178,118,224,539,342,94,69550,8168,856,,7312,0.104799216,2,1044,2
20/05/2021,Delta,18,1758898,88439,1621572,48887,421354,4674,405714,7169,3797,8471,5797,610,4969,218,20,179,431,265,895,696,151,69701,14265,932,,13333,0.065334735,1,1485,2
21/05/2021,Delta,19,1764644,89429,1626142,49073,422210,4966,405918,7184,4142,9108,5746,990,4570,186,15,204,345,292,856,637,138,69839,8669,867,,7802,0.100011535,2,1485,2
22/05/2021,Delta,20,1769940,91240,1629495,49205,423142,5260,406300,7196,4386,9646,5296,1811,3353,132,12,382,244,294,932,538,117,69956,8361,819,,7542,0.09795479,2,1556,2
23/05/2021,Delta,21,1775220,92847,1633045,49328,424009,5389,406669,7207,4744,10133,5280,1607,3550,123,11,369,358,129,867,487,113,70069,9341,384,,8957,0.041109089,1,1158,2
24/05/2021,Delta,22,1781127,93393,1638279,49455,424828,5537,406987,7225,5079,10616,5907,546,5234,127,18,318,335,148,819,483,133,70202,13768,617,,13151,0.044814062,1,1169,2
25/05/2021,Delta,23,1786187,94486,1642074,49627,425212,5463,407493,7239,5017,10480,5060,1093,3795,172,14,506,-62,-74,384,-136,153,70355,8524,940,,7584,0.110276865,2,278,2
26/05/2021,Delta,24,1791221,96187,1645263,49771,425829,5567,408019,7250,4993,10560,5034,1701,3189,144,11,526,-24,104,617,80,117,70472,9599,693,,8906,0.07219502,1,858,2
27/05/2021,Delta,25,1797499,98405,1649187,49907,426769,5633,408585,7271,5280,10913,6278,2218,3924,136,21,566,287,66,940,353,117,70589,13247,807,,12440,0.060919453,1,1135,2
28/05/2021,Delta,26,1803361,98704,1654557,50100,427462,5516,409497,7288,5161,10677,5862,299,5370,193,17,912,-119,-117,693,-236,136,70725,10573,1064,,9509,0.10063369,2,510,2
29/05/2021,Delta,27,1809926,99690,1659974,50262,428269,5461,410508,7296,5004,10465,6565,986,5417,162,8,1011,-157,-55,807,-212,131,70856,7322,726,,6596,0.099153237,2,721,2
30/05/2021,Delta,28,1816041,101639,1663998,50404,429333,5429,411495,7309,5100,10529,6115,1949,4024,142,13,987,96,-32,1064,64,131,70987,6847,519,,6328,0.07579962,1,1039,2
31/05/2021,Delta,29,1821703,102006,1669119,50578,430059,5417,412074,7327,5241,10658,5662,367,5121,174,18,579,141,-12,726,129,131,71118,6917,601,,6316,0.086887379,1,756,2
01/06/2021,Delta,30,1826527,101325,1674479,50723,430578,5422,412593,7349,5214,10636,4824,-681,5360,145,22,519,-27,5,519,-22,121,71239,9849,714,,9135,0.07249467,1,595,2
02/06/2021,Delta,31,1831773,100364,1680501,50908,431179,5461,413179,7361,5178,10639,5246,-961,6022,185,12,586,-36,39,601,3,142,71381,14450,906,,13544,0.062698962,1,715,2
03/06/2021,Delta,32,1837126,94438,1691593,51095,431893,5430,413680,7381,5402,10832,5353,-5926,11092,187,20,501,224,-31,714,193,139,71520,10605,1317,,9288,0.124186704,2,712,2
04/06/2021,Delta,33,1843612,94773,1697543,51296,432799,5487,414496,7402,5414,10901,6486,335,5950,201,21,816,12,57,906,69,134,71654,7625,1019,,6606,0.133639344,2,1083,2
05/06/2021,Delta,34,1850206,96973,1701784,51449,434116,5620,415317,7423,5756,11376,6594,2200,4241,153,21,821,342,133,1317,475,151,71805,6698,1197,,5501,0.178710063,2,1646,3
06/06/2021,Delta,35,1856038,98455,1705971,51612,435135,5550,416181,7438,5966,11516,5832,1482,4187,163,15,864,210,-70,1019,140,154,71959,7237,755,,6482,0.104324997,2,924,2
07/06/2021,Delta,36,1863031,99663,1711565,51803,436332,5620,416994,7457,6261,11881,6993,1208,5594,191,19,813,295,70,1197,365,150,72109,11167,1376,,9791,0.123220202,2,1394,2
08/06/2021,Delta,37,1869325,99963,1717370,51992,437087,5555,417997,7478,6057,11612,6294,300,5805,189,21,1003,-204,-65,755,-269,159,72268,12304,2096,,10208,0.170351105,2,688,2
09/06/2021,Delta,38,1877050,101635,1723253,52162,438458,5730,419109,7499,6120,11850,7725,1672,5883,170,21,1112,63,175,1371,238,158,72426,13142,2293,,10849,0.17447877,2,1784,3
10/06/2021,Delta,39,1885901,104614,1728914,52373,440554,5829,420211,7523,6991,12820,8851,2979,5661,211,24,1102,871,99,2096,970,145,72571,13443,2455,,10988,0.182622926,2,2366,3
11/06/2021,Delta,40,1894025,106315,1735144,52566,442847,6158,421396,7543,7750,13908,8124,1701,6230,193,20,1185,759,329,2293,1088,166,72737,11800,2769,,9031,0.234661017,2,3011,3
12/06/2021,Delta,41,1901490,108324,1740436,52730,445302,6769,422121,7557,8855,15624,7465,2009,5292,164,14,725,1105,611,2455,1716,156,72893,11671,2722,,8949,0.233227658,2,3719,3
13/06/2021,Delta,42,1911358,113388,1745091,52879,448071,7410,423056,7571,10034,17444,9868,5064,4655,149,14,935,1179,641,2769,1820,149,73042,8970,1502,,7468,0.167447046,2,4093,3
14/06/2021,Delta,43,1919547,115197,1751234,53116,450793,7856,424088,7609,11240,19096,8189,1809,6143,237,38,1032,1206,446,2722,1652,192,73234,15269,2376,,12893,0.155609405,2,3728,3
15/06/2021,Delta,44,1927708,116787,1757641,53280,452295,8142,425417,7634,11102,19244,8161,1590,6407,164,25,1329,-138,286,1502,148,206,73440,16499,4144,,12355,0.251166737,3,2149,3
16/06/2021,Delta,45,1937652,120306,1763870,53476,454671,8756,426695,7665,11555,20311,9944,3519,6229,196,31,1278,453,614,2376,1067,228,73668,17368,4737,,12631,0.272742976,3,3697,3
17/06/2021,Delta,46,1950276,125303,1771220,53753,458815,9284,428764,7713,13054,22338,12624,4997,7350,277,48,2069,1499,528,4144,2027,221,73889,16797,4895,,11902,0.291421087,3,5344,3
18/06/2021,Delta,47,1963266,130096,1779127,54043,463552,9560,431264,7777,14951,24511,12990,4793,7907,290,64,2500,1897,276,4737,2173,236,74125,16636,5582,,11054,0.335537389,3,5481,3
19/06/2021,Delta,48,1976172,135738,1786143,54291,468447,10325,433499,7836,16787,27112,12906,5642,7016,248,59,2235,1836,765,4895,2601,220,74345,15424,5014,,10410,0.325077801,3,6602,3
20/06/2021,Delta,49,1989909,142719,1792528,54662,474029,11037,435982,7905,19105,30142,13737,6981,6385,371,69,2483,2318,712,5582,3030,253,74598,14462,3221,,11241,0.222721615,2,7213,3
21/06/2021,Delta,50,2004445,147728,1801761,54956,479043,11343,439007,7976,20717,32060,14536,5009,9233,294,71,3025,1612,306,5014,1918,245,74843,19485,4693,,14792,0.240851937,2,5839,3
22/06/2021,Delta,51,2018113,152686,1810136,55291,482264,11024,442059,8014,21167,32191,13668,4958,8375,335,38,3052,450,-319,3221,131,327,75170,20460,7505,,12955,0.366813294,3,2697,3
23/06/2021,Delta,52,2033421,160524,1817303,55594,486957,12837,443195,8057,22868,35705,15308,7838,7167,303,43,1136,1701,1813,4693,3514,306,75476,20155,6934,,13221,0.344033739,3,8448,3
24/06/2021,Delta,53,2053995,171542,1826504,55949,494462,14234,445718,8107,26403,40637,20574,11018,9201,355,50,2523,3535,1397,7505,4932,365,75841,22911,9271,,13640,0.404652787,3,10449,3
25/06/2021,Delta,54,2072867,181435,1835061,56371,501396,15606,448288,8177,29325,44931,18872,9893,8557,422,70,2570,2922,1372,6934,4294,417,76258,24704,9394,,15310,0.380262306,3,9888,3
26/06/2021,Delta,55,2093962,194776,1842457,56729,510667,17605,451013,8220,33829,51434,21095,13341,7396,358,43,2725,4504,1999,9271,6503,396,76654,24295,8348,,15947,0.343609796,3,13398,3
27/06/2021,Delta,56,2115304,207685,1850481,57138,520061,18831,454497,8269,38464,57295,21342,12909,8024,409,49,3484,4635,1226,9394,5861,500,77154,22046,7379,,14667,0.334709244,3,11993,3
28/06/2021,Delta,57,2135998,218476,1859961,57561,528409,19874,457935,8348,42252,62126,20694,10791,9480,423,79,3438,3788,1043,8348,4831,611,77765,22432,7680,,14752,0.342368046,3,10671,3
29/06/2021,Delta,58,2156465,228835,1869606,58024,535788,20419,461439,8426,45504,65923,20467,10359,9645,463,78,3504,3252,545,7379,3797,507,78272,21394,7541,,13853,0.352482004,3,8703,3
30/06/2021,Delta,59,2178272,239368,1880413,58491,543468,22210,464943,8486,47829,70039,21807,10533,10807,467,60,3504,2325,1791,7680,4116,627,78899,25285,9399,,15886,0.371722365,3,11442,3
01/07/2021,Delta,60,2203108,253826,1890287,58995,551009,24184,468461,8528,49836,74020,24836,14458,9874,504,42,3518,2007,1974,7541,3981,647,79546,24478,9702,,14776,0.396355911,3,11615,3
02/07/2021,Delta,61,2228938,267539,1901865,59534,560408,25380,473467,8547,53014,78394,25830,13713,11578,539,19,5006,3178,1196,9399,4374,762,80308,24616,10485,,14131,0.425942476,3,11848,3
03/07/2021,Delta,62,2256851,281677,1915147,60027,570110,27442,479150,8577,54941,82383,27913,14138,13282,493,30,5683,1927,2062,9702,3989,600,80908,27356,10903,,16453,0.398559731,3,13916,3
04/07/2021,Delta,63,2284084,295228,1928274,60582,580595,27687,484949,8652,59307,86994,27233,13551,13127,555,75,5799,4366,245,10485,4611,681,81589,25309,9439,,15870,0.372950334,3,11200,3
05/07/2021,Delta,64,2313829,309999,1942690,61140,591498,28290,491556,8779,62873,91163,29745,14771,14416,558,127,6607,3566,603,10903,4169,833,82422,25453,9366,,16087,0.367972341,3,12490,3
06/07/2021,Delta,65,2345018,324597,1958553,61868,600937,29136,497492,8861,65448,94584,31189,14598,15863,728,82,5936,2575,846,9439,3421,684,83106,28003,12974,,15029,0.463307503,3,11377,3
07/07/2021,Delta,66,2379397,343101,1973388,62908,610303,30418,501199,9042,69644,100062,34379,18504,14835,1040,181,3707,4196,1282,9366,5478,727,83833,31847,13112,,18735,0.411718529,3,12473,3
08/07/2021,Delta,67,2417788,359455,1994573,63760,623277,29721,512085,9110,72361,102082,38391,16354,21185,852,68,10886,2717,-697,12974,2020,710,84543,30950,12920,,18030,0.417447496,3,11784,3
09/07/2021,Delta,68,2455912,367733,2023548,64631,636389,26903,526941,9306,73239,100142,38124,8278,28975,871,196,14856,878,-2818,13112,-1940,742,85285,35642,13133,,22509,0.368469783,3,8064,3
10/07/2021,Delta,69,2491006,373440,2052109,65457,649309,24273,543867,9357,71812,96085,35094,5707,28561,826,51,16926,-1427,-2630,12920,-4057,823,86108,35376,14619,,20757,0.413246269,3,7813,3
11/07/2021,Delta,70,2527203,376015,2084724,66464,662442,20359,564437,9395,68251,88610,36197,2575,32615,1007,38,20570,-3561,-3914,13133,-7475,700,86808,31632,12182,,19450,0.385116338,3,5419,3
12/07/2021,Delta,71,2567630,380797,2119478,67355,677061,16106,584912,9462,66581,82687,40427,4782,34754,891,67,20475,-1670,-4253,14619,-5923,627,87435,43067,12667,,30400,0.294123111,3,6314,3
13/07/2021,Delta,72,2615529,407709,2139601,68219,689243,18368,589486,9541,71848,90216,47899,26912,20123,864,79,4574,5267,2262,12182,7529,547,87982,41734,12691,,29043,0.304092586,3,16943,3
14/07/2021,Delta,73,2670046,443473,2157363,69210,701910,21180,592556,9603,78571,99751,54517,35764,17762,991,62,3070,6723,2812,12667,9535,532,88514,41580,12415,,29165,0.298581049,3,18477,3
15/07/2021,Delta,74,2726803,480199,2176412,70192,714601,22978,595582,9743,86298,109276,56757,36726,19049,982,140,3026,7727,1798,12691,9525,573,89087,38512,10168,,28344,0.264021604,3,16707,3
16/07/2021,Delta,75,2780803,504915,2204491,71397,727016,24843,604033,9845,88295,113138,54000,24716,28079,1205,102,8451,1997,1865,12415,3862,579,89666,34278,9128,,25150,0.266293249,3,16451,3
17/07/2021,Delta,76,2832755,527872,2232394,72489,737184,23713,615640,9902,87929,111642,51952,22957,27903,1092,57,11607,-366,-1130,10168,-1496,510,90176,21828,5000,,16828,0.229063588,2,8079,3
18/07/2021,Delta,77,2877476,542236,2261658,73582,746312,22271,627481,10103,86457,108728,44721,14364,29264,1093,201,11841,-1472,-1442,9128,-2914,512,90688,30678,6213,,24465,0.202522981,2,6847,3
19/07/2021,Delta,78,2911733,542938,2293875,74920,751312,19521,640171,10345,81275,100796,34257,702,32217,1338,242,12690,-5182,-2750,5000,-7932,484,91172,26083,5904,,20179,0.22635433,2,226,2
20/07/2021,Delta,79,2950058,550192,2323666,76200,757525,18897,652242,10610,75776,94673,38325,7254,29791,1280,265,12071,-5499,-624,6213,-6123,461,91633,31541,7058,,24483,0.223772233,2,5760,3
21/07/2021,Delta,80,2983830,549694,2356553,77583,763429,17822,662800,10692,72115,89937,33772,-498,32887,1383,82,10558,-3661,-1075,5904,-4736,423,92056,35589,8033,,27556,0.225715811,2,4000,3
22/07/2021,Delta,81,3033339,561384,2392923,79032,770487,17224,673424,10865,68974,86198,49509,11690,36370,1449,173,10624,-3141,-598,7058,-3739,355,92411,32547,8360,,24187,0.256859311,3,6381,3
23/07/2021,Delta,82,3082410,569901,2431911,80598,778520,16846,687864,11021,62789,79635,49071,8517,38988,1566,156,14440,-6185,-378,8033,-6563,333,92744,27435,5393,,22042,0.19657372,2,7745,3
24/07/2021,Delta,83,3127826,574135,2471678,82013,786880,16276,702477,11181,56946,73222,45416,4234,39767,1415,160,14613,-5843,-570,8360,-6413,323,93067,24602,2662,,21940,0.108202585,2,7700,3
25/07/2021,Delta,84,3166505,573908,2509318,83279,792273,15168,716838,11333,48934,64102,38679,-227,37640,1266,152,14361,-8012,-1108,5393,-9120,292,93359,23979,3567,,20412,0.148755161,2,3633,3
26/07/2021,Delta,85,3194733,560275,2549692,84766,794935,13724,731504,11436,38271,51995,28228,-13633,40374,1487,103,14666,-10663,-1444,2662,-12107,300,93659,28249,5525,,22724,0.195582145,2,83,1
27/07/2021,Delta,86,3239936,556281,2596820,86835,798502,13848,746087,11606,26961,40809,45203,-3994,47128,2069,170,14583,-11310,124,3567,-11186,307,93966,25442,3845,,21597,0.151128056,2,4325,3
28/07/2021,Delta,87,3287727,558392,2640676,88659,804027,12885,757122,11688,22332,35217,47791,2111,43856,1824,82,11035,-4629,-963,5525,-5592,274,94240,23582,3454,,20128,0.146467645,2,3845,3
29/07/2021,Delta,88,3331206,554484,2686170,90552,807872,10790,768562,11844,16676,27466,43479,-3908,45494,1893,156,11440,-5656,-2095,3845,-7751,286,94526,24573,3329,,21244,0.135473894,2,123,1
30/07/2021,Delta,89,3372374,549343,2730720,92311,811326,8390,779720,11952,11264,19654,41168,-5141,44550,1759,108,11158,-5412,-2400,3454,-7812,237,94763,19619,2701,,16918,0.137672664,2,-1022,1
31/07/2021,Delta,90,3409658,545447,2770092,94119,814653,7716,784668,12135,10134,17850,37284,-3896,39372,1808,183,4948,-1130,-674,3327,-1804,258,95021,11587,1410,,10177,0.121688099,2,2528,3
01/08/2021,Delta,91,3440396,535135,2809538,95723,817354,6485,789261,12209,9399,15884,30738,-10312,39446,1604,74,4593,-735,-1231,2701,-1966,217,95238,15952,1601,,14351,0.100363591,2,461,2
02/08/2021,Delta,92,3462800,523164,2842345,97291,818764,5777,791422,12363,9202,14979,22404,-11971,32807,1568,154,2161,-197,-708,1410,-905,230,95468,25595,2982,,22613,0.11650713,2,456,2
03/08/2021,Delta,93,3496700,524142,2873669,98889,820365,5299,793928,12433,8705,14004,33900,978,31324,1598,70,2506,-497,-478,1601,-975,201,95669,21154,2311,,18843,0.109246478,2,855,2
04/08/2021,Delta,94,3532567,524011,2907920,100636,823346,4916,796381,12514,9535,14451,35867,-131,34251,1747,81,2453,830,-383,2981,447,218,95887,20760,2185,,18575,0.105250482,2,2458,3
05/08/2021,Delta,95,3568331,518310,2947646,102375,825657,4419,799151,12629,9458,13877,35764,-5701,39726,1739,115,2770,-77,-497,2311,-574,209,96096,20398,2008,,18390,0.098441024,2,1662,3
06/08/2021,Delta,96,3607863,507375,2996478,104010,827842,3974,802373,12682,8813,12787,39532,-10935,48832,1635,53,3222,-645,-445,2185,-1090,186,96282,17018,1649,,15369,0.096897403,2,1454,2
07/08/2021,Delta,97,3639616,497824,3036194,105598,829850,3219,806924,12750,6957,10176,31753,-9551,39716,1588,68,4551,-1856,-755,2008,-2611,199,96481,8155,727,,7428,0.089147762,1,702,2
08/08/2021,Delta,98,3666031,474233,3084702,107096,831499,3075,808087,12770,7567,10642,26415,-23591,48508,1498,20,1163,610,-144,1649,466,171,96652,15094,1425,,13669,0.094408374,2,1421,2
09/08/2021,Delta,99,3686740,448508,3129661,108571,832226,2926,809087,12783,7430,10356,20709,-25725,44959,1475,13,1000,-137,-149,727,-286,154,96806,21813,1958,,19855,0.089762985,1,468,2
10/08/2021,Delta,100,3718821,437055,3171147,110619,833651,3024,810308,12824,7495,10519,32081,-11453,41486,2048,41,1221,65,98,1425,163,170,96976,14615,1078,,13537,0.073759836,1,1744,3
11/08/2021,Delta,101,3749446,426170,3211078,112198,835609,3228,811642,12866,7873,11101,30625,-10885,39931,1579,42,1334,378,204,1958,582,143,97119,15419,1210,,14209,0.078474609,1,2492,3
12/08/2021,Delta,102,3774155,412776,3247715,113664,836687,2873,813898,12908,7008,9881,24709,-13394,36637,1466,42,2256,-865,-355,1078,-1220,169,97288,16144,1363,,14781,0.084427651,1,494,2
13/08/2021,Delta,103,3804943,400129,3289718,115096,837897,2729,815468,12976,6724,9453,30788,-12647,42003,1432,68,1570,-284,-144,1210,-428,146,97434,14374,1182,,13192,0.082231807,1,1126,2
14/08/2021,Delta,104,3833541,395577,3321598,116366,839260,2820,816687,13005,6748,9568,28598,-4552,31880,1270,29,1219,24,91,1363,115,125,97559,6076,513,,5563,0.084430546,1,1632,3
15/08/2021,Delta,105,3854354,384807,3351959,117588,840442,2901,817764,13022,6755,9656,20813,-10770,30361,1222,17,1077,7,81,1182,88,149,97708,11663,655,,11008,0.056160508,1,1395,2
16/08/2021,Delta,106,3871738,371021,3381884,118833,840955,2915,818700,13050,6290,9205,17384,-13786,29925,1245,28,936,-465,14,513,-451,150,97858,12623,1029,,11594,0.081517864,1,625,2
17/08/2021,Delta,107,3892479,358357,3414109,120013,841610,2961,819620,13074,5955,8916,20741,-12664,32225,1180,24,920,-335,46,655,-289,143,98001,11136,731,,10405,0.06564296,1,819,2
18/08/2021,Delta,108,3908247,343203,3443903,121141,842639,3029,820517,13087,6006,9035,15768,-15154,29794,1128,13,897,51,68,1029,119,136,98137,11742,969,,10773,0.082524272,1,1204,2
19/08/2021,Delta,109,3930300,334752,3472915,122633,843370,3004,821451,13121,5794,8798,22053,-8451,29012,1492,34,934,-212,-25,731,-237,113,98250,13518,891,,12627,0.065912117,1,783,2
20/08/2021,Delta,110,3950304,327286,3499037,123981,844339,3087,822399,13132,5721,8808,20004,-7466,26122,1348,11,948,-73,83,969,10,143,98393,11555,701,,10854,0.060666378,1,1168,2
21/08/2021,Delta,111,3967048,319658,3522048,125342,845230,3199,823314,13152,5565,8764,16744,-7628,23011,1361,20,915,-156,112,891,-44,113,98506,8317,485,,7832,0.058314296,1,1175,2
22/08/2021,Delta,112,3979456,306760,3546324,126372,845931,2947,824227,13173,5584,8531,12408,-12898,24276,1030,21,913,19,-252,701,-233,123,98629,9206,484,,8722,0.052574408,1,260,2
23/08/2021,Delta,113,3989060,290764,3571082,127214,846416,2788,824958,13193,5477,8265,9604,-15996,24758,842,20,731,-107,-159,485,-266,118,98747,15471,789,,14682,0.050998643,1,227,2
24/08/2021,Delta,114,4008166,273750,3606164,128252,846900,2847,825573,13203,5277,8124,19106,-17014,35082,1038,10,615,-200,59,484,-141,109,98856,12823,574,,12249,0.044763316,1,632,2
25/08/2021,Delta,115,4026837,257677,3639867,129293,847689,2731,826302,13214,5442,8173,18671,-16073,33703,1041,11,729,165,-116,789,49,111,98967,16879,638,,16241,0.037798448,1,590,2
26/08/2021,Delta,116,4043736,243588,3669966,130182,848263,2604,827333,13216,5110,7714,16899,-14089,30099,889,2,1031,-332,-127,574,-459,124,99091,14187,468,,13719,0.032987947,1,326,2
27/08/2021,Delta,117,4056354,236317,3689256,130781,848901,2504,827674,13232,5491,7995,12618,-7271,19290,599,16,341,381,-100,638,281,119,99210,14584,474,,14110,0.032501371,1,486,2
28/08/2021,Delta,118,4066404,227182,3707850,131372,849369,2395,828125,13242,5607,8002,10050,-9135,18594,591,10,451,116,-109,468,7,121,99331,8657,341,,8316,0.039390089,1,280,2
29/08/2021,Delta,119,4073831,217590,3724318,131923,849843,2256,828838,13252,5497,7753,7427,-9592,16468,551,10,713,-110,-139,474,-249,125,99456,16231,399,,15832,0.024582589,1,226,2
30/08/2021,Delta,120,4079267,203060,3743716,132491,850184,2158,829668,13261,5097,7255,5436,-14530,19398,568,9,830,-400,-98,341,-498,141,99597,18231,673,,17558,0.036915145,1,172,2
31/08/2021,Delta,121,4089801,196281,3760497,133023,850583,2116,830197,13290,4980,7096,10534,-6779,16781,532,29,529,-117,-42,399,-159,111,99708,13941,430,,13511,0.030844272,1,402,2
01/09/2021,Delta,122,4100138,189571,3776891,133676,851256,2172,831293,13302,4489,6661,10337,-6710,16394,653,12,1096,-491,56,673,-435,110,99818,13431,343,,13088,0.025537935,1,821,2
02/09/2021,Delta,123,4109093,176638,3798099,134356,851686,2043,832130,13312,4201,6244,8955,-12933,21208,680,10,837,-288,-129,430,-417,121,99939,14685,360,,14325,0.024514811,1,202,2
03/09/2021,Delta,124,4116890,168317,3813643,134930,852029,1914,832952,13322,3841,5755,7797,-8321,15544,574,10,822,-360,-129,343,-489,116,100055,12141,303,,11838,0.024956758,1,115,1
04/09/2021,Delta,125,4123617,160699,3827449,135469,852389,1813,833437,13332,3807,5620,6727,-7618,13806,539,10,485,-34,-101,360,-135,124,100179,11183,217,,10966,0.019404453,1,188,2
05/09/2021,Delta,126,4129020,155519,3837640,135861,852692,1765,833765,13342,3820,5585,5403,-5180,10191,392,10,328,13,-48,303,-35,112,100291,13151,262,,12889,0.019922439,1,237,2
06/09/2021,Delta,127,4133433,146271,3850689,136473,852909,1644,834489,13359,3417,5061,4413,-9248,13049,612,17,724,-403,-121,217,-524,118,100409,19121,428,,18693,0.022383767,1,26,1
07/09/2021,Delta,128,4140634,138630,3864848,137156,853171,1597,835030,13372,3172,4769,7201,-7641,14159,683,13,541,-245,-47,262,-292,129,100538,18285,308,,17977,0.016844408,1,207,2
08/09/2021,Delta,129,4147365,132823,3876760,137782,853599,1536,835700,13386,2977,4513,6731,-5807,11912,626,14,670,-195,-61,428,-256,112,100650,18047,261,,17786,0.014462237,1,348,2
09/09/2021,Delta,130,4153355,127829,3887410,138116,853907,1478,836187,13399,2843,4321,5990,-4994,10650,334,13,487,-134,-58,308,-192,95,100745,17209,268,,16941,0.015573247,1,231,2
10/09/2021,Delta,131,4158731,118534,3901766,138431,854168,1454,836644,13411,2659,4113,5376,-9295,14356,315,12,457,-184,-24,261,-208,136,100881,19577,306,,19271,0.015630587,1,249,2
11/09/2021,Delta,132,4163732,115679,3909352,138701,854436,1418,837033,13431,2554,3972,5001,-2855,7586,270,20,389,-105,-36,268,-141,127,101008,13840,187,,13653,0.013511561,1,256,2
12/09/2021,Delta,133,4167511,109869,3918753,138889,854742,1402,837364,13437,2539,3941,3779,-5810,9401,188,6,331,-15,-16,306,-31,131,101139,15592,190,,15402,0.012185736,1,292,2
13/09/2021,Delta,134,4170088,99696,3931227,139165,854929,1227,837805,13443,2454,3681,2577,-10173,12474,276,6,441,-85,-175,187,-260,102,101241,20532,305,,20227,0.014854861,1,-145,1
14/09/2021,Delta,135,4174216,92328,3942473,139415,855119,1100,838306,13445,2268,3368,4128,-7368,11246,250,2,501,-186,-127,190,-313,116,101357,16660,176,,16484,0.010564226,1,-58,1
15/09/2021,Delta,136,4178164,84963,3953519,139682,855424,1066,838680,13455,2223,3289,3948,-7365,11046,267,10,374,-45,-34,305,-79,91,101448,14910,206,,14704,0.013816231,1,267,2
16/09/2021,Delta,137,4181309,73238,3968152,139919,855600,1022,839022,13464,2092,3114,3145,-11725,14633,237,9,342,-131,-44,176,-175,104,101552,17660,200,,17460,0.011325028,1,115,1
17/09/2021,Delta,138,4185144,68942,3976064,140138,855806,1000,839379,13469,1958,2958,3835,-4296,7912,219,5,357,-134,-22,206,-156,98,101650,17459,155,,17304,0.008877943,1,177,2
18/09/2021,Delta,139,4188529,65066,3983140,140323,856006,974,839623,13475,1934,2908,3385,-3876,7076,185,6,244,-24,-26,200,-50,112,101762,12877,91,,12786,0.007066863,1,166,2
19/09/2021,Delta,140,4190763,60969,3989326,140468,856161,963,839803,13479,1916,2879,2234,-4097,6186,145,4,180,-18,-11,155,-29,114,101876,13769,106,,13663,0.007698453,1,145,2
20/09/2021,Delta,141,4192695,55936,3996125,140634,856252,864,840212,13482,1694,2558,1932,-5033,6799,166,3,409,-222,-99,91,-321,96,101972,19402,227,,19175,0.011699825,1,-98,1
21/09/2021,Delta,142,4195958,52447,4002706,140805,856358,795,840525,13486,1552,2347,3263,-3489,6581,171,4,313,-142,-69,106,-211,120,102092,18376,165,,18211,0.008979103,1,-20,1
22/09/2021,Delta,143,4198678,49662,4008062,140954,856585,774,840812,13490,1509,2283,2720,-2785,5356,149,4,287,-43,-21,227,-64,109,102201,18526,181,,18345,0.009770053,1,197,2
23/09/2021,Delta,144,4201559,47997,4012448,141114,856750,687,841065,13493,1505,2192,2881,-1665,4386,160,3,253,-4,-87,165,-91,104,102305,17438,133,,17305,0.007627021,1,0,1
24/09/2021,Delta,145,4204116,45803,4017055,141258,856931,632,841393,13497,1409,2041,2557,-2194,4607,144,4,328,-96,-55,181,-151,102,102407,18351,168,,18183,0.009154814,1,83,1
25/09/2021,Delta,146,4206253,44071,4020801,141381,857064,591,841592,13500,1381,1972,2137,-1732,3746,123,3,199,-28,-41,133,-69,138,102545,13724,103,,13621,0.007505101,1,60,1
26/09/2021,Delta,147,4208013,42769,4023777,141467,857232,607,841719,13503,1403,2010,1760,-1302,2976,86,3,127,22,16,168,38,89,102634,13943,104,,13839,0.00745894,1,209,2
27/09/2021,Delta,148,4209403,40270,4027548,141585,857335,552,841980,13507,1296,1848,1390,-2499,3771,118,4,261,-107,-55,103,-162,103,102737,18523,177,,18346,0.009555688,1,5,1
28/09/2021,Delta,149,4211460,38652,4031099,141709,857439,540,842141,13512,1246,1786,2057,-1618,3551,124,5,161,-50,-12,104,-62,105,102842,17365,149,,17216,0.008580478,1,95,1
29/09/2021,Delta,150,4213414,37412,4034176,141826,857616,534,842336,13516,1230,1764,1954,-1240,3077,117,4,195,-16,-6,177,-22,112,102954,18240,151,,18089,0.008278509,1,177,2
30/09/2021,Delta,151,4215104,36141,4037024,141939,857765,510,842541,13519,1195,1705,1690,-1271,2848,113,3,205,-35,-24,149,-59,118,103072,18445,155,,18290,0.008403361,1,110,1
01/10/2021,Delta,152,4216728,34867,4039835,142026,857916,504,842715,13524,1173,1677,1624,-1274,2811,87,5,174,-22,-6,151,-28,115,103187,17832,127,,17705,0.007122028,1,154,2
02/10/2021,Delta,153,4218142,33812,4042215,142115,858071,483,842842,13529,1217,1700,1414,-1055,2380,89,5,127,44,-21,155,23,110,103297,13384,149,,13235,0.011132696,1,128,1
03/10/2021,Delta,154,4219284,32876,4044235,142173,858198,500,842929,13534,1235,1735,1142,-936,2020,58,5,87,18,17,127,35,83,103380,12844,72,,12772,0.00560573,1,176,2
04/10/2021,Delta,155,4220206,31054,4046891,142261,858347,461,843091,13534,1261,1722,922,-1822,2656,88,0,162,26,-39,149,-13,104,103484,21780,203,,21577,0.009320478,1,71,1
05/10/2021,Delta,156,4221610,29823,4049449,142338,858419,444,843239,13538,1198,1642,1404,-1231,2558,77,4,148,-63,-17,72,-80,111,103595,18395,149,,18246,0.008100027,1,50,1
06/10/2021,Delta,157,4223094,28381,4052300,142413,858622,451,843414,13540,1217,1668,1484,-1442,2851,75,2,175,19,7,203,26,96,103691,19404,150,,19254,0.007730365,1,223,2
07/10/2021,Delta,158,4224487,27747,4054246,142494,858771,448,843529,13541,1253,1701,1393,-634,1946,81,1,115,36,-3,149,33,108,103799,17794,100,,17694,0.005619872,1,146,2
08/10/2021,Delta,159,4225871,25551,4057760,142560,858921,436,843738,13541,1206,1642,1384,-2196,3514,66,0,209,-47,-12,150,-59,103,103902,18605,140,,18465,0.007524859,1,126,1
09/10/2021,Delta,160,4227038,25159,4059267,142612,859021,427,843822,13543,1229,1656,1167,-392,1507,52,2,84,23,-9,100,14,89,103991,12260,41,,12219,0.003344209,1,88,1
10/10/2021,Delta,161,4227932,24430,4060851,142651,859161,438,843891,13547,1285,1723,894,-729,1584,39,4,69,56,11,140,67,120,104111,16889,143,,16746,0.00846705,1,174,2
11/10/2021,Delta,162,4228552,22541,4063295,142716,859202,386,844189,13549,1078,1464,620,-1889,2444,65,2,298,-207,-52,41,-259,101,104212,21231,278,,20953,0.013094061,1,-57,1
12/10/2021,Delta,163,4229813,21625,4065425,142763,859345,310,844538,13550,947,1257,1261,-916,2130,47,1,349,-131,-76,143,-207,109,104321,17864,113,,17751,0.006325571,1,-6,1
13/10/2021,Delta,164,4231046,20551,4067684,142811,859623,359,844742,13550,972,1331,1233,-1074,2259,48,0,204,25,49,278,74,94,104415,20351,124,,20227,0.006093067,1,376,2
14/10/2021,Delta,165,4232099,19852,4069399,142848,859736,369,844839,13550,978,1347,1053,-699,1715,37,0,97,6,10,113,16,89,104504,22549,154,,22395,0.006829571,1,133,2
15/10/2021,Delta,166,4233014,19318,4070807,142889,859860,379,844901,13550,1030,1409,915,-534,1408,41,0,62,52,10,124,62,113,104617,21227,131,,21096,0.006171385,1,144,2
16/10/2021,Delta,167,4234011,18746,4072332,142933,860014,350,845121,13551,992,1342,997,-572,1525,44,1,220,-38,-29,154,-67,119,104736,14349,107,,14242,0.007456966,1,99,1
17/10/2021,Delta,168,4234758,18388,4073418,142952,860145,348,845248,13551,998,1346,747,-358,1086,19,0,127,6,-2,131,4,117,104853,14429,106,,14323,0.007346316,1,127,1
18/10/2021,Delta,169,4235384,17374,4075011,142999,860252,330,845386,13552,984,1314,626,-1014,1593,47,1,138,-14,-18,107,-32,94,104947,22453,103,,22350,0.00458736,1,74,1
19/10/2021,Delta,170,4236287,16697,4076541,143049,860358,331,845508,13552,967,1298,903,-677,1530,50,0,122,-17,1,106,-16,99,105046,21758,89,,21669,0.004090449,1,108,1
20/10/2021,Delta,171,4237201,16376,4077748,143077,860461,312,845650,13552,947,1259,914,-321,1207,28,0,142,-20,-19,103,-39,111,105157,20511,83,,20428,0.004046609,1,65,1
21/10/2021,Delta,172,4237834,15594,4079120,143120,860550,300,845763,13553,934,1234,633,-782,1372,43,1,113,-13,-12,89,-25,94,105251,23401,116,,23285,0.004957053,1,68,1
22/10/2021,Delta,173,4238594,15090,4080351,143153,860633,301,845884,13553,895,1196,760,-504,1231,33,0,121,-39,1,83,-38,108,105359,23593,131,,23462,0.005552494,1,85,1
23/10/2021,Delta,174,4239396,14803,4081417,143176,860749,292,846056,13555,846,1138,802,-287,1066,23,2,172,-49,-9,116,-58,107,105466,20235,82,,20153,0.004052384,1,104,1
24/10/2021,Delta,175,4240019,14360,4082454,143205,860880,287,846185,13556,852,1139,623,-443,1037,29,1,129,6,-5,131,1,81,105547,19306,37,,19269,0.001916503,1,124,1
25/10/2021,Delta,176,4240479,13554,4083690,143235,860962,279,846352,13557,774,1053,460,-806,1236,30,1,167,-78,-8,82,-86,102,105649,25232,105,,25127,0.004161382,1,69,1
26/10/2021,Delta,177,4241090,12989,4084831,143270,860999,256,846525,13558,660,916,611,-565,1141,35,1,173,-114,-23,37,-137,121,105770,26464,131,,26333,0.004950121,1,-6,1
27/10/2021,Delta,178,4241809,12735,4085775,143299,861104,260,846667,13559,618,878,719,-254,944,29,1,142,-42,4,105,-38,96,105866,25283,96,,25187,0.003797018,1,116,1
28/10/2021,Delta,179,4242532,12440,4086759,143333,861235,256,846749,13560,670,926,723,-295,984,34,1,82,52,-4,131,48,84,105950,24574,96,,24478,0.003906568,1,126,1
29/10/2021,Delta,180,4243215,12414,4087440,143361,861331,259,846799,13560,713,972,683,-26,681,28,0,50,43,3,96,46,84,106034,25218,113,,25105,0.004480926,1,102,1
30/10/2021,Delta,181,4243835,12309,4088138,143388,861427,264,846942,13561,660,924,620,-105,698,27,1,143,-53,5,96,-48,82,106116,17331,83,,17248,0.004789106,1,109,1
31/10/2021,Delta,182,4244358,12318,4088635,143405,861540,271,847021,13562,686,957,523,9,497,17,1,79,26,7,113,33,95,106211,19417,77,,19340,0.003965597,1,130,2
01/11/2021,Delta,183,4244761,11919,4089419,143423,861623,273,847066,13562,722,995,403,-399,784,18,0,45,36,2,83,38,101,106312,26076,132,,25944,0.005062126,1,87,1
02/11/2021,Delta,184,4245373,11629,4090287,143457,861700,266,847201,13562,671,937,612,-290,868,34,0,135,-51,-7,77,-58,95,106407,23477,111,,23366,0.004728032,1,63,1
03/11/2021,Delta,185,4246174,11592,4091101,143481,861832,258,847353,13563,658,916,801,-37,814,24,1,152,-13,-8,132,-21,109,106516,19214,119,,19095,0.006193401,1,119,1
04/11/2021,Delta,186,4246802,11364,4091938,143500,861943,258,847403,13564,718,976,628,-228,837,19,1,50,60,0,111,60,100,106616,18245,69,,18176,0.003781858,1,114,1
05/11/2021,Delta,187,4247320,11215,4092586,143519,862061,256,847438,13565,802,1058,518,-149,648,19,1,35,84,-2,118,82,97,106713,16615,117,,16498,0.00704183,1,117,1
06/11/2021,Delta,188,4247721,10979,4093208,143534,862130,231,847685,13566,648,879,401,-236,622,15,1,247,-154,-25,69,-179,96,106809,9511,29,,9482,0.003049101,1,22,1
07/11/2021,Delta,189,4248165,10825,4093795,143545,862247,220,847808,13566,653,873,444,-154,587,11,0,123,5,-11,117,-6,92,106901,14697,94,,14603,0.006395863,1,95,1
08/11/2021,Delta,190,4248409,9774,4095078,143557,862276,198,847885,13566,627,825,244,-1051,1283,12,0,77,-26,-22,29,-48,84,106985,17374,95,,17279,0.005467941,1,-15,1
09/11/2021,Delta,191,4248843,9602,4095663,143578,862370,193,848034,13566,577,770,434,-172,585,21,0,149,-50,-5,94,-55,99,107084,17264,107,,17157,0.006197868,1,84,1
10/11/2021,Delta,192,4249323,9537,4096194,143592,862465,198,848093,13566,608,806,480,-65,531,14,0,59,31,5,95,36,94,107178,15336,71,,15265,0.00462963,1,105,1
11/11/2021,Delta,193,4249758,9486,4096664,143608,862572,208,848137,13567,660,868,435,-51,470,16,1,44,52,10,107,62,119,107297,15674,54,,15620,0.003445196,1,130,2
12/11/2021,Delta,194,4250157,9305,4097224,143628,862643,187,848311,13567,578,765,399,-181,560,20,0,174,-82,-21,71,-103,103,107400,17445,92,,17353,0.005273717,1,29,1
13/11/2021,Delta,195,4250516,9197,4097675,143644,862697,177,848419,13567,534,711,359,-108,451,16,0,108,-44,-10,54,-54,90,107490,9564,36,,9528,0.003764115,1,34,1
14/11/2021,Delta,196,4250855,9018,4098178,143659,862789,180,848527,13568,514,694,339,-179,503,15,1,108,-20,3,92,-17,95,107585,11402,79,,11323,0.006928609,1,101,1
15/11/2021,Delta,197,4251076,8522,4098884,143670,862825,175,848604,13569,477,652,221,-496,706,11,1,77,-37,-5,36,-42,96,107681,15629,130,,15499,0.008317871,1,29,1
16/11/2021,Delta,198,4251423,8339,4099399,143685,862904,178,848710,13569,447,625,347,-183,515,15,0,106,-30,3,79,-27,88,107769,17131,100,,17031,0.005837371,1,85,1
17/11/2021,Delta,199,4251945,8390,4099857,143698,863034,196,848871,13570,397,593,522,51,458,13,1,161,-50,18,130,-32,96,107865,16614,97,,16517,0.00583845,1,169,2
18/11/2021,Delta,200,4252345,8315,4100321,143709,863134,212,849007,13571,344,556,400,-75,464,11,1,136,-53,16,100,-37,105,107970,14882,114,,14768,0.007660261,1,135,2
19/11/2021,Delta,201,4252705,8154,4100837,143714,863231,199,849111,13573,348,547,360,-161,516,5,2,104,4,-13,97,-9,102,108072,16109,111,,15998,0.006890558,1,77,1
20/11/2021,Delta,202,4253098,8154,4101216,143728,863345,209,849265,13574,297,506,393,0,379,14,1,154,-51,10,114,-41,111,108183,10428,26,,10402,0.002493287,1,137,2
21/11/2021,Delta,203,4253412,8126,4101547,143739,863456,200,849386,13574,296,496,314,-28,331,11,0,121,-1,-9,111,-10,123,108306,14261,69,,14192,0.00483837,1,93,1
22/11/2021,Delta,204,4253598,7965,4101889,143744,863482,182,849448,13574,278,460,186,-161,342,5,0,62,-18,-18,26,-36,97,108403,16878,82,,16796,0.004858396,1,-10,1
23/11/2021,Delta,205,4253992,7916,4102323,143753,863551,183,849491,13574,303,486,394,-49,434,9,0,43,25,1,69,26,107,108510,15369,54,,15315,0.003513566,1,71,1
24/11/2021,Delta,206,4254443,7977,4102700,143766,863633,168,849596,13575,294,462,451,61,377,13,1,105,-9,-15,82,-24,88,108598,15137,70,,15067,0.00462443,1,55,1
25/11/2021,Delta,207,4254815,8040,4102993,143782,863687,199,849638,13576,274,473,372,63,293,16,1,42,-20,31,54,11,96,108694,15116,54,,15062,0.003572374,1,119,1
26/11/2021,Delta,208,4255268,8093,4103379,143796,863757,196,849693,13576,292,488,453,53,386,14,0,55,18,-3,70,15,94,108788,12527,51,,12476,0.004071206,1,64,1
27/11/2021,Omicron,1,4255672,8226,4103639,143807,863811,204,849779,13576,252,456,404,133,260,11,0,86,-40,8,54,-32,110,108898,12196,41,,12155,0.003361758,1,70,1
28/11/2021,Omicron,2,4255936,8214,4103914,143808,863862,183,849831,13576,272,455,264,-12,275,1,0,52,20,-21,51,-1,81,108979,12551,44,,12507,0.003505697,1,9,1
29/11/2021,Omicron,3,4256112,7960,4104333,143819,863903,170,849902,13576,255,425,176,-254,419,11,0,71,-17,-13,41,-30,100,109079,16423,70,,16353,0.004262315,1,15,1
30/11/2021,Omicron,4,4256409,7922,4104657,143830,863947,178,849929,13576,264,442,297,-38,324,11,0,27,9,8,44,17,108,109187,15289,28,,15261,0.001831382,1,60,1
01/12/2021,Omicron,5,4256687,7883,4104964,143840,864017,180,849979,13576,282,462,278,-39,307,10,0,50,18,2,70,20,88,109275,14524,42,,14482,0.002891765,1,74,1
02/12/2021,Omicron,6,4256998,7796,4105352,143850,864045,175,850046,13576,248,423,311,-87,388,10,0,67,-34,-5,28,-39,93,109368,13796,48,,13748,0.003479269,1,18,1
03/12/2021,Omicron,7,4257243,7705,4105680,143858,864087,167,850114,13577,229,396,245,-91,328,8,1,68,-19,-8,42,-27,122,109490,15314,43,,15271,0.002807888,1,29,1
04/12/2021,Omicron,8,4257489,7632,4105994,143863,864135,173,850175,13578,209,382,246,-73,314,5,1,61,-20,6,48,-14,101,109591,7787,14,,7773,0.001797868,1,63,1
05/12/2021,Omicron,9,4257685,7526,4106292,143867,864178,161,850228,13579,210,371,196,-106,298,4,1,53,1,-12,43,-11,98,109689,9519,31,,9488,0.003256645,1,22,1
06/12/2021,Omicron,10,4257815,5642,4108297,143876,864192,149,850281,13581,181,330,130,-1884,2005,9,2,53,-29,-12,14,-41,102,109791,17151,41,,17110,0.002390531,1,-4,1
07/12/2021,Omicron,11,4258076,5466,4108717,143893,864223,151,850319,13582,171,322,261,-176,420,17,1,38,-10,2,31,-8,99,109890,14679,36,,14643,0.002452483,1,38,1
08/12/2021,Omicron,12,4258340,5363,4109068,143909,864264,147,850364,13583,170,317,264,-103,351,16,1,45,-1,-4,41,-5,112,110002,13320,26,,13294,0.001951952,1,36,1
09/12/2021,Omicron,13,4258560,5278,4109364,143918,864300,125,850439,13583,153,278,220,-85,296,9,0,75,-17,-22,36,-39,119,110121,15304,32,,15272,0.002090957,1,-8,1
10/12/2021,Omicron,14,4258752,5154,4109675,143923,864326,124,850475,13583,144,268,192,-124,311,5,0,36,-9,-1,26,-10,106,110227,14197,32,,14165,0.002253997,1,24,1
11/12/2021,Omicron,15,4258980,5186,4109865,143929,864358,126,850517,13583,132,258,228,32,190,6,0,42,-12,2,32,-10,99,110326,11401,16,,11385,0.001403386,1,36,1
12/12/2021,Omicron,16,4259143,5158,4110049,143936,864390,122,850557,13583,128,250,163,-28,184,7,0,40,-4,-4,32,-8,89,110415,10130,20,,10110,0.001974334,1,24,1
13/12/2021,Omicron,17,4259249,4974,4110327,143948,864406,117,850595,13583,111,228,106,-184,278,12,0,38,-17,-5,16,-22,82,110497,14367,23,,14344,0.001600891,1,6,1
14/12/2021,Omicron,18,4259439,4905,4110574,143960,864426,119,850621,13583,103,222,190,-69,247,12,0,26,-8,2,20,-6,106,110603,16251,40,,16211,0.002461387,1,24,1
15/12/2021,Omicron,19,4259644,4864,4110811,143969,864449,113,850649,13583,104,217,205,-41,237,9,0,28,1,-6,23,-5,105,110708,18257,38,,18219,0.002081393,1,11,1
16/12/2021,Omicron,20,4259857,4833,4111045,143979,864489,113,850685,13583,108,221,213,-31,234,10,0,36,4,0,40,4,107,110815,15379,74,,15305,0.004811756,1,40,1
17/12/2021,Omicron,21,4260148,4912,4111250,143986,864527,107,850719,13583,118,225,291,79,205,7,0,34,10,-6,38,4,114,110929,15153,43,,15110,0.002837722,1,26,1
18/12/2021,Omicron,22,4260380,4918,4111464,143998,864601,131,850751,13583,136,267,232,6,214,12,0,32,18,24,74,42,87,111016,12587,38,,12549,0.003018988,1,122,1
19/12/2021,Omicron,23,4260544,4923,4111619,144002,864644,124,850797,13583,140,264,164,5,155,4,0,46,4,-7,43,-3,88,111104,15269,55,,15214,0.00360207,1,29,1
20/12/2021,Omicron,24,4260677,4829,4111835,144013,864682,131,850817,13584,150,281,133,-94,216,11,1,20,10,7,38,17,114,111218,15054,43,,15011,0.002856384,1,55,1
21/12/2021,Omicron,25,4260893,4829,4112040,144024,864737,156,850837,13584,160,316,216,0,205,11,0,20,10,25,55,35,109,111327,15079,16,,15063,0.001061078,1,105,1
22/12/2021,Omicron,26,4261072,4746,4112292,144034,864780,162,850858,13584,176,338,179,-83,252,10,0,21,16,6,43,22,101,111428,14203,69,,14134,0.004858129,1,55,1
23/12/2021,Omicron,27,4261208,4642,4112524,144042,864796,145,850910,13584,157,302,136,-104,232,8,0,52,-19,-17,16,-36,112,111540,14223,80,,14143,0.005624692,1,-18,1
24/12/2021,Omicron,28,4261412,4659,4112706,144047,864865,174,850939,13584,168,342,204,17,182,5,0,29,11,29,69,40,90,111630,10342,47,,10295,0.004544576,1,127,1
25/12/2021,Omicron,29,4261667,4713,4112901,144053,864945,207,850984,13584,170,377,255,54,195,6,0,45,2,33,80,35,95,111725,9549,42,,9507,0.004398366,1,146,2
26/12/2021,Omicron,30,4261759,4655,4113049,144055,864992,224,851008,13584,176,400,92,-58,148,2,0,24,6,17,47,23,84,111809,12038,96,,11942,0.007974747,1,81,1
27/12/2021,Omicron,31,4261879,4496,4113320,144063,865034,183,851096,13584,171,354,120,-159,271,8,0,88,-5,-41,42,-46,116,111925,14302,27,,14275,0.001887848,1,-40,1
28/12/2021,Omicron,32,4262157,4614,4113472,144071,865130,171,851138,13585,236,407,278,118,152,8,1,42,65,-12,96,53,115,112040,11109,53,,11056,0.004770906,1,75,1
29/12/2021,Omicron,33,4262351,4528,4113742,144081,865157,165,851167,13587,238,403,194,-86,270,10,2,29,2,-6,27,-4,100,112140,11608,87,,11521,0.007494831,1,21,1
30/12/2021,Omicron,34,4262540,4311,4114141,144088,865210,171,851201,13587,251,422,189,-217,399,7,0,34,13,6,53,19,96,112236,13075,118,,12957,0.009024857,1,65,1
31/12/2021,Omicron,35,4262720,4292,4114334,144094,865297,192,851222,13588,295,487,180,-19,193,6,1,21,44,21,87,65,91,112327,9458,103,,9355,0.010890252,1,132,2
01/01/2022,Omicron,36,4262994,4399,4114499,144096,865415,205,851280,13588,342,547,274,107,165,2,0,58,47,13,118,60,91,112418,9521,172,,9349,0.018065329,1,144,2
02/01/2022,Omicron,37,4263168,4382,4114689,144097,865518,116,851386,13588,428,544,174,-17,190,1,0,106,86,-89,103,-3,101,112519,11419,115,,11304,0.010070934,1,-75,1
03/01/2022,Omicron,38,4263433,4530,4114801,144102,865690,140,851408,13588,554,694,265,148,112,5,0,22,126,24,172,150,102,112621,13289,259,,13030,0.019489804,1,220,2
04/01/2022,Omicron,39,4263732,4658,4114969,144105,865805,141,851449,13588,627,768,299,128,168,3,0,41,73,1,115,74,106,112727,13027,267,,12760,0.020495893,1,117,1
05/01/2022,Omicron,40,4264136,4878,4115149,144109,866064,168,851520,13589,787,955,404,220,180,4,1,71,160,27,259,187,122,112849,13259,300,,12959,0.022626141,1,316,2
06/01/2022,Omicron,41,4264669,5195,4115358,144116,866331,214,851572,13589,956,1170,533,317,209,7,0,52,169,46,267,215,97,112946,12711,278,,12433,0.021870821,1,359,2
07/01/2022,Omicron,42,4265187,5494,4115572,144121,866631,221,851648,13589,1173,1394,518,299,214,5,0,76,217,7,300,224,96,113042,14858,393,,14465,0.026450397,1,314,2
08/01/2022,Omicron,43,4265666,5792,4115747,144127,866909,257,851727,13589,1336,1593,479,298,175,6,0,79,163,36,278,199,103,113145,11292,360,,10932,0.031880978,1,350,2
09/01/2022,Omicron,44,4266195,6108,4115958,144129,867302,299,851839,13589,1575,1874,529,316,211,2,0,112,239,42,393,281,89,113234,13106,537,,12569,0.0409736,1,477,2
10/01/2022,Omicron,45,4266649,6311,4116202,144136,867662,322,851944,13589,1807,2129,454,203,244,7,0,105,232,23,360,255,100,113334,13965,412,,13553,0.029502327,1,406,2
11/01/2022,Omicron,46,4267451,6659,4116648,144144,868199,402,852126,13590,2081,2483,802,348,446,8,1,182,274,80,537,354,76,113410,13820,478,,13342,0.034587554,1,700,2
12/01/2022,Omicron,47,4268097,6985,4116962,144150,868611,506,852269,13590,2246,2752,646,326,314,6,0,143,165,104,412,269,83,113493,18143,554,,17589,0.030535193,1,620,2
13/01/2022,Omicron,48,4268890,7388,4117347,144155,869089,583,852563,13590,2353,2936,793,403,385,5,0,294,107,77,478,184,85,113578,18046,720,,17326,0.039898038,1,632,2
14/01/2022,Omicron,49,4269740,7877,4117700,144163,869643,669,852727,13591,2656,3325,850,489,353,8,1,164,303,86,554,389,79,113657,17748,566,,17182,0.031890917,1,729,2
15/01/2022,Omicron,50,4270794,8463,4118164,144167,870363,758,853003,13591,3011,3769,1054,586,464,4,0,276,355,89,720,444,76,113733,12741,493,,12248,0.03869398,1,898,2
16/01/2022,Omicron,51,4271649,8605,4118874,144170,870929,771,853522,13591,3045,3816,855,142,710,3,0,519,34,13,566,47,88,113821,13605,670,,12935,0.049246601,1,592,2
17/01/2022,Omicron,52,4272421,8775,4119472,144174,871422,809,853987,13591,3035,3844,772,170,598,4,0,465,-10,38,493,28,96,113917,17249,1012,,16237,0.058670068,1,569,2
18/01/2022,Omicron,53,4273783,9564,4120036,144183,872092,981,854204,13591,3316,4297,1362,789,564,9,0,217,281,172,670,453,85,114002,19560,1155,,18405,0.05904908,1,1014,2
19/01/2022,Omicron,54,4275528,10796,4120540,144192,873104,1125,854589,13591,3799,4924,1745,1232,504,9,0,385,483,144,1012,627,105,114107,21643,1484,,20159,0.068567204,1,1300,2
20/01/2022,Omicron,55,4277644,12328,4121117,144199,874259,1222,855026,13591,4420,5642,2116,1532,577,7,0,437,621,97,1155,718,86,114193,22117,1825,,20292,0.082515712,1,1349,2
21/01/2022,Omicron,56,4280248,14119,4121928,144201,875743,1445,855676,13591,5031,6476,2604,1791,811,2,0,650,611,223,1484,834,94,114287,19130,1739,,17391,0.090904339,2,1930,3
22/01/2022,Omicron,57,4283453,16692,4122555,144206,877568,1710,856137,13591,6130,7840,3205,2573,627,5,0,461,1099,265,1825,1364,90,114377,18113,1993,,16120,0.110031469,2,2355,3
23/01/2022,Omicron,58,4286378,18891,4123267,144220,879307,2011,856653,13597,7046,9057,2925,2199,712,14,6,516,916,301,1739,1217,112,114489,19533,2190,,17343,0.112117954,2,2359,3
24/01/2022,Omicron,59,4289305,20867,4124211,144227,881300,2242,857215,13597,8246,10488,2927,1976,944,7,0,562,1200,231,1993,1431,108,114597,27395,3509,,23886,0.128089067,2,2455,3
25/01/2022,Omicron,60,4294183,24856,4125080,144247,883490,2721,857688,13606,9475,12196,4878,3989,869,20,9,473,1229,479,2190,1708,86,114683,29894,4149,,25745,0.138790393,2,3175,3
26/01/2022,Omicron,61,4301193,29277,4127662,144254,886999,3232,859305,13612,10850,14082,7010,4421,2582,7,6,1617,1375,511,3509,1886,85,114768,31120,4558,,26562,0.146465296,2,4549,3
27/01/2022,Omicron,62,4309270,35704,4129305,144261,891148,3989,861203,13615,12341,16330,8077,6427,1643,7,3,1898,1491,757,4149,2248,102,114870,34609,5765,,28844,0.166575168,2,5672,3
28/01/2022,Omicron,63,4319175,43574,4131333,144268,895706,4709,862670,13617,14710,19419,9905,7870,2028,7,2,1467,2369,720,4558,3089,107,114977,37417,6613,,30804,0.176737846,2,6004,3
29/01/2022,Omicron,64,4330763,52555,4133923,144285,901471,5545,864447,13627,17852,23397,11588,8981,2590,17,10,1777,3142,836,5765,3978,97,115074,29951,5268,,24683,0.175887283,2,7467,3
30/01/2022,Omicron,65,4343185,61718,4137164,144303,908093,6348,866477,13639,21629,27977,12422,9163,3241,18,12,2030,3777,803,6622,4580,93,115167,35683,6391,,29292,0.179104896,2,8264,3
31/01/2022,Omicron,66,4353370,68596,4140454,144320,913355,6809,867519,13666,25361,32170,10185,6878,3290,17,27,1042,3732,461,5262,4193,91,115258,42329,9132,,33197,0.215738619,2,6265,3
01/02/2022,Omicron,67,4369391,81349,4143694,144348,919743,8018,869184,13678,28863,36881,16021,12753,3240,28,12,1665,3502,1209,6388,4711,114,115372,48365,10317,,38048,0.213315414,2,8842,3
02/02/2022,Omicron,68,4387286,94109,4148804,144373,928875,8590,873212,13689,33384,41974,17895,12760,5110,25,11,4028,4521,572,9132,5093,130,115502,55471,13179,,42292,0.237583602,2,10309,3
03/02/2022,Omicron,69,4414483,115275,4154797,144411,939192,9652,877579,13713,38248,47900,27197,21166,5993,38,24,4367,4864,1062,10317,5926,136,115638,59293,12774,,46519,0.215438585,2,12513,3
04/02/2022,Omicron,70,4446694,140254,4161987,144453,952371,11534,883377,13738,43722,55256,32211,24979,7190,42,25,5798,5474,1882,13179,7356,151,115789,60406,15825,,44581,0.261977287,3,17018,3
05/02/2022,Omicron,71,4480423,163468,4172458,144497,965145,13198,891571,13767,46609,59807,33729,23214,10471,44,29,8194,2887,1664,12774,4551,117,115906,53369,12682,,40687,0.237628586,2,16189,3
06/02/2022,Omicron,72,4516480,188899,4183027,144554,980970,14625,899957,13794,52594,67219,36057,25431,10569,57,27,8386,5985,1427,15825,7412,120,116026,47982,10817,,37165,0.225438706,2,18760,3
07/02/2022,Omicron,73,4542601,206361,4191604,144636,993652,15512,905285,13832,59023,74535,26121,17462,8577,82,38,5328,6429,887,12682,7316,128,116154,55262,14353,,40909,0.259726394,3,14570,3
08/02/2022,Omicron,74,4580093,233062,4202312,144719,1004469,17221,910435,13872,62941,80162,37492,26701,10708,83,40,5150,3918,1709,10817,5627,151,116305,43363,11090,,32273,0.255747988,3,14355,3
09/02/2022,Omicron,75,4626936,265824,4216328,144784,1018822,18150,923652,13889,63131,81281,46843,32762,14016,65,17,13217,190,929,14353,1119,139,116444,60664,10707,,49957,0.176496769,2,16262,3
10/02/2022,Omicron,76,4667554,288186,4234510,144858,1029912,19445,929100,13911,67456,86901,40618,22362,18182,74,22,5448,4325,1295,11090,5620,102,116546,48831,12417,,36414,0.254285188,3,13746,3
11/02/2022,Omicron,77,4708043,312808,4250277,144958,1040619,19925,945079,13950,61665,81590,40489,24622,15767,100,39,15979,-5791,480,10707,-5311,125,116671,57063,10172,,46891,0.178259117,2,11784,3
12/02/2022,Omicron,78,4763252,335340,4282847,145065,1053036,19198,960624,13989,59225,78423,55209,22532,32570,107,39,15545,-2440,-727,12417,-3167,127,116798,47037,10275,,36762,0.218445054,2,11080,3
13/02/2022,Omicron,79,4807778,352839,4309763,145176,1063208,18900,975674,14032,54602,73502,44526,17499,26916,111,43,15050,-4623,-298,10172,-4921,124,116922,45132,9482,,35650,0.210094833,2,9705,3
14/02/2022,Omicron,80,4844279,375857,4323101,145321,1073483,20873,975770,14085,62755,83628,36501,23018,13338,145,53,96,8153,1973,10275,10126,121,117043,56203,12388,,43815,0.22041528,2,14380,3
15/02/2022,Omicron,81,4901328,406025,4349848,145455,1082965,20748,984861,14135,63221,83969,57049,30168,26747,134,50,9091,466,-125,9482,341,141,117184,58034,8536,,49498,0.147086191,2,9382,3
16/02/2022,Omicron,82,4966046,445190,4375234,145622,1095353,21717,992213,14191,67232,88949,64718,39165,25386,167,56,7352,4011,969,12388,4980,139,117323,57003,8189,,48814,0.143659106,2,14494,3
17/02/2022,Omicron,83,5030002,469868,4414306,145828,1103889,20132,1008870,14255,60632,80764,63956,24678,39072,206,64,16657,-6600,-1585,8536,-8185,137,117460,53128,9453,,43675,0.177928776,2,5558,3
18/02/2022,Omicron,84,5089637,496383,4447210,146044,1112078,8564,1020564,14301,68649,77213,59635,26515,32904,216,46,11694,8017,-1156,8189,-3551,133,117593,50715,8136,,42579,0.160425909,2,6015,3
19/02/2022,Omicron,85,5149021,520910,4481909,146202,1121531,8002,1031739,14326,67464,75466,59384,24527,34699,158,25,11175,-1185,-562,9453,-1747,137,117730,42099,5358,,36741,0.127271432,2,8404,3
20/02/2022,Omicron,86,5197505,536358,4514782,146365,1129667,7933,1043718,14358,63658,71591,48484,15448,32873,163,32,11979,-3806,-69,8136,-3875,130,117860,41144,5208,,35936,0.126579817,2,8094,3
21/02/2022,Omicron,87,5231923,530671,4554711,146541,1135025,7102,1055584,14382,57957,65059,34418,-5687,39929,176,24,11866,-5701,-831,5358,-6532,133,117993,53089,7295,,45794,0.137410763,2,3768,3
22/02/2022,Omicron,88,5289414,549431,4593185,146798,1140233,7054,1064272,14415,54492,61546,57491,18760,38474,257,33,8688,-3465,-48,5208,-3513,131,118124,42656,6855,,35801,0.160704239,2,5211,3
44615,Omicron,89,5350902,571522,4632355,147025,1147528,6892,1071054,14466,55116,62008,61488,22091,39170,227,51,6782,624,-162,7295,462,143,118430,40395,4524,,35871,0.111994059,2,7124,3
44616,Omicron,90,5408328,586113,4674873,147342,1154383,6793,1082827,14513,50250,57043,57426,14591,42518,317,47,11773,-4866,-99,6855,-4965,104,118534,40636,4675,,35961,0.115045772,2,6798,3
44617,Omicron,91,5457775,573955,4736234,147586,1158907,6540,1091226,14555,46586,53126,49447,-12158,61361,244,42,8399,-3664,-253,4524,-3917,140,118674,36117,3957,,32160,0.109560595,2,4144,3
44618,Omicron,92,5504418,578535,4778039,147844,1163582,5924,1100117,14585,42956,48880,46643,4580,41805,258,30,8891,-3630,-616,4675,-4246,127,118801,33599,7300,,26299,0.217268371,2,3533,3
44619,Omicron,93,5539394,573898,4817423,148073,1167539,5580,1109056,14609,38294,43874,34976,-4637,39384,229,24,8939,-4662,-344,3957,-5006,142,118943,28529,3634,,24895,0.127379158,2,3341,3
44620,Omicron,94,5564448,554698,4861415,148335,1174839,5441,1120433,14664,34301,39742,25054,-19200,43992,262,55,11377,-3993,-139,7300,-4132,116,119059,34276,4196,,30080,0.122418018,2,7187,3
44621,Omicron,95,5589176,539210,4901302,148664,1178473,5077,1126008,14690,32698,37775,24728,-15488,39887,329,26,5575,-1603,-364,3634,-1967,86,119145,35101,4669,,30432,0.133016153,2,2984,3
44622,Omicron,96,5630096,536823,4944237,149036,1182669,4885,1129828,14710,33246,38131,40920,-2387,42935,372,20,3820,548,-192,4196,356,118,119263,29509,3727,,25782,0.126300451,2,3872,3
44623,Omicron,97,5667355,531696,4986391,149268,1187338,4527,1137499,14730,30582,35109,37259,-5127,42154,232,20,7671,-2664,-358,4669,-3022,100,119363,27599,3059,,24540,0.110837349,2,4013,3
44624,Omicron,98,5693702,517253,5026853,149596,1191065,4557,1143134,14754,28620,33177,26347,-14443,40462,328,24,5635,-1962,30,3727,-1932,115,119478,30686,3669,,27017,0.119565926,2,3859,3
44625,Omicron,99,5723858,500418,5073522,149918,1194124,4654,1148415,14779,26276,30930,30156,-16835,46669,322,25,5281,-2344,97,3059,-2247,112,119590,27104,2693,,24411,0.099358028,2,3328,3
44626,Omicron,100,5748725,475951,5122602,150172,1197793,4615,1152865,14798,25515,30130,24867,-24467,49080,254,19,4450,-761,-39,3669,-800,99,119689,26370,3569,,22801,0.135343193,2,3648,3
44627,Omicron,101,5770105,448273,5171402,150430,1200486,4747,1156926,14828,23985,28732,21380,-27678,48800,258,30,4061,-1530,132,2693,-1398,89,119778,30159,3872,,26287,0.12838622,2,3047,3
44628,Omicron,102,5800253,422892,5226530,150831,1204055,4711,1161139,14852,23353,28064,30148,-25381,55128,401,24,4213,-632,-36,3569,-668,117,119895,27247,3546,,23701,0.130142768,2,3569,3
44629,Omicron,103,5826589,417219,5258235,151135,1207927,4585,1164852,14863,23627,28212,26336,-5673,31705,304,11,3713,274,-126,3872,148,110,120005,22414,2548,,19866,0.113678951,2,3653,3
44630,Omicron,104,5847900,399852,5296634,151413,1211473,4563,1168549,14881,23480,28043,21311,-17367,38399,278,18,3697,-147,-22,3546,-169,96,120101,22022,2105,,19917,0.095586232,2,3556,3
44631,Omicron,105,5864010,376461,5335846,151703,1214021,4124,1173761,14896,21240,25364,16110,-23391,39212,290,15,5212,-2240,-439,2548,-2679,69,120170,19114,1874,,17240,0.098043319,2,1715,3
44632,Omicron,106,5878910,357380,5369579,151951,1216126,3796,1178124,14921,19285,23081,14900,-19081,33733,248,25,4363,-1955,-328,2105,-2283,35,120205,21238,1874,,17240,0.088238064,1,1524,2
